,population,female,male,total_deaths,total_cases,clusters,cluster
0,55200,28326,26874,240.0,19819.0,0,pink
1,208107,106919,101188,735.0,70014.0,0,pink
2,25782,12085,13697,105.0,7460.0,0,pink
3,22527,10375,12152,117.0,8116.0,0,pink
4,57645,29211,28434,267.0,18738.0,0,pink
5,10352,4689,5663,58.0,3068.0,0,pink
6,20025,10657,9368,133.0,6564.0,0,pink
7,115098,59783,55315,682.0,41409.0,0,pink
8,33826,17569,16257,180.0,10906.0,0,pink
9,25853,13033,12820,96.0,6797.0,0,pink
10,43930,22258,21672,220.0,13012.0,0,pink
11,13075,6822,6253,41.0,2293.0,0,pink
12,24387,12848,11539,111.0,8627.0,0,pink
13,13378,6914,6464,94.0,5201.0,0,pink
14,14938,7657,7281,73.0,4435.0,0,pink
15,51288,25974,25314,261.0,17252.0,0,pink
16,54495,28420,26075,278.0,21399.0,0,pink
17,12514,6477,6037,79.0,3626.0,0,pink
18,10855,5354,5501,64.0,3803.0,0,pink
19,37351,19179,18172,263.0,11788.0,0,pink
20,13865,7051,6814,119.0,4807.0,0,pink
21,82313,41753,40560,401.0,31630.0,0,pink
22,49255,25021,24234,252.0,16544.0,0,pink
23,40029,21581,18448,263.0,11099.0,0,pink
24,71200,35896,35304,349.0,22577.0,0,pink
25,81212,41762,39450,373.0,30051.0,0,pink
26,37328,18261,19067,186.0,12447.0,0,pink
27,102939,53288,49651,703.0,34481.0,0,pink
28,16585,8415,8170,103.0,5935.0,0,pink
29,31542,15940,15602,159.0,12111.0,0,pink
30,26491,13520,12971,175.0,7971.0,0,pink
31,8426,4476,3950,55.0,2310.0,0,pink
32,14887,7868,7019,113.0,5757.0,0,pink
33,17124,8892,8232,81.0,5893.0,0,pink
34,104352,54323,50029,540.0,32744.0,0,pink
35,52094,26558,25536,258.0,18520.0,0,pink
36,659892,347544,312348,2568.0,239229.0,1,purple
37,13933,7133,6800,74.0,4746.0,0,pink
38,92585,48270,44315,428.0,30558.0,0,pink
39,33171,17168,16003,187.0,9439.0,0,pink
40,159287,80915,78372,384.0,47769.0,0,pink
41,93052,46625,46427,317.0,32253.0,0,pink
42,10236,5406,4830,82.0,3391.0,0,pink
43,19054,10264,8790,94.0,5325.0,0,pink
44,357560,182895,174665,1093.0,116643.0,0,pink
45,19538,10092,9446,122.0,6244.0,0,pink
46,29965,15067,14898,169.0,10184.0,0,pink
47,95145,48168,46977,425.0,33030.0,0,pink
48,414659,216731,197928,1791.0,135377.0,1,purple
49,21512,11282,10230,90.0,6802.0,0,pink
50,226941,119587,107354,1021.0,73833.0,0,pink
51,119122,60462,58660,558.0,46574.0,0,pink
52,9486,5050,4436,53.0,2747.0,0,pink
53,20298,10590,9708,124.0,6354.0,0,pink
54,33403,17376,16027,142.0,9343.0,0,pink
55,22574,11585,10989,80.0,6560.0,0,pink
56,58213,30089,28124,103.0,13110.0,0,pink
57,211261,108783,102478,496.0,78325.0,0,pink
58,87306,43551,43755,445.0,33397.0,0,pink
59,12985,6971,6014,57.0,3204.0,0,pink
60,80565,41409,39156,402.0,28673.0,0,pink
61,40636,21119,19517,262.0,14805.0,0,pink
62,206213,106674,99539,861.0,71049.0,0,pink
63,64493,32987,31506,487.0,24399.0,0,pink
64,16643,8223,8420,65.0,4459.0,0,pink
65,10809,5675,5134,50.0,3688.0,0,pink
66,23875,12035,11840,147.0,9581.0,0,pink
67,3425,1436,1989,5.0,1340.0,0,pink
68,5750,2318,3432,3.0,2006.0,0,pink
69,296112,144968,151144,613.0,124062.0,0,pink
70,18040,8659,9381,48.0,12939.0,0,pink
71,890,364,526,0.0,0.0,0,pink
72,1375,665,710,1.0,1254.0,0,pink
73,2232,1115,1117,2.0,1803.0,0,pink
74,4975,2402,2573,13.0,2270.0,0,pink
75,99653,45807,53846,172.0,33566.0,0,pink
76,2518,1183,1335,1.0,816.0,0,pink
77,2132,1037,1095,0.0,0.0,0,pink
78,32330,15813,16517,30.0,11946.0,0,pink
79,58220,27906,30314,132.0,22618.0,0,pink
80,13804,6744,7060,27.0,5142.0,0,pink
81,13649,6368,7281,13.0,5879.0,0,pink
82,8198,3810,4388,16.0,4923.0,0,pink
83,103464,49552,53912,278.0,40705.0,0,pink
84,9925,4685,5240,7.0,7600.0,0,pink
85,9797,3681,6116,17.0,5518.0,0,pink
86,7734,3578,4156,22.0,5755.0,0,pink
87,3255,1606,1649,9.0,930.0,0,pink
88,6474,2960,3514,10.0,1848.0,0,pink
89,8738,4267,4471,10.0,3513.0,0,pink
90,1061,506,555,1.0,693.0,0,pink
91,6876,3097,3779,21.0,2479.0,0,pink
92,9301,4403,4898,0.0,0.0,0,pink
93,2484,1182,1302,2.0,813.0,0,pink
94,689,320,369,5.0,986.0,0,pink
95,5415,2505,2910,13.0,1750.0,0,pink
96,71522,36282,35240,655.0,35935.0,0,pink
97,126279,62144,64135,665.0,39033.0,0,pink
98,140217,71299,68918,549.0,52742.0,0,pink
99,53400,27030,26370,450.0,21500.0,0,pink
100,37879,17549,20330,198.0,14176.0,0,pink
101,9504,4440,5064,48.0,2747.0,0,pink
102,20701,10024,10677,170.0,6021.0,0,pink
103,4253913,2149768,2104145,19017.0,1526639.0,2,dark purple
104,206064,102017,104047,1700.0,67115.0,0,pink
105,108705,54172,54533,981.0,48406.0,0,pink
106,1019722,517843,501879,4369.0,315478.0,1,purple
107,419721,200673,219048,1875.0,156521.0,1,purple
108,46584,24299,22285,255.0,19790.0,0,pink
109,224645,114850,109795,1427.0,60089.0,0,pink
110,207829,100856,106973,1313.0,71250.0,0,pink
111,18124,9391,8733,106.0,7041.0,0,pink
112,20537,10524,10013,89.0,6234.0,0,pink
113,41219,21227,19992,290.0,10748.0,0,pink
114,258980,130581,128399,1011.0,77175.0,0,pink
115,37288,18938,18350,212.0,11241.0,0,pink
116,10948,5734,5214,59.0,3603.0,0,pink
117,5202,2595,2607,15.0,1217.0,0,pink
118,27887,13990,13897,123.0,7273.0,0,pink
119,10826,5560,5266,69.0,3149.0,0,pink
120,22385,11757,10628,99.0,6426.0,0,pink
121,15061,7647,7414,104.0,5140.0,0,pink
122,25230,12758,12472,153.0,8040.0,0,pink
123,8226,4088,4138,42.0,2680.0,0,pink
124,23892,12448,11444,108.0,6781.0,0,pink
125,20906,10724,10182,85.0,6578.0,0,pink
126,105701,54173,51528,398.0,47118.0,0,pink
127,62472,31711,30761,308.0,18617.0,0,pink
128,49013,25742,23271,250.0,16666.0,0,pink
129,16998,8798,8200,108.0,5758.0,0,pink
130,7432,3814,3618,41.0,2086.0,0,pink
131,11887,6264,5623,46.0,3657.0,0,pink
132,18502,9469,9033,85.0,5636.0,0,pink
133,122416,62505,59911,370.0,42858.0,0,pink
134,17780,9105,8675,89.0,4490.0,0,pink
135,12139,6091,6048,101.0,3140.0,0,pink
136,98296,51114,47182,586.0,26993.0,0,pink
137,18086,9216,8870,68.0,5240.0,0,pink
138,44623,22711,21912,206.0,19692.0,0,pink
139,22018,11524,10494,83.0,5636.0,0,pink
140,33520,16102,17418,168.0,13051.0,0,pink
141,13389,6949,6440,65.0,4668.0,0,pink
142,37264,19172,18092,237.0,12762.0,0,pink
143,13559,6541,7018,82.0,4739.0,0,pink
144,17225,8713,8512,76.0,7265.0,0,pink
145,70424,35518,34906,332.0,22323.0,0,pink
146,26291,13315,12976,108.0,8202.0,0,pink
147,6915,3534,3381,31.0,1510.0,0,pink
148,16669,8399,8270,90.0,6520.0,0,pink
149,9398,4089,5309,71.0,3350.0,0,pink
150,13695,5105,8590,71.0,5509.0,0,pink
151,12417,6327,6090,113.0,3886.0,0,pink
152,21757,11114,10643,99.0,6085.0,0,pink
153,72206,36539,35667,284.0,23930.0,0,pink
154,16076,8038,8038,71.0,4862.0,0,pink
155,16438,8448,7990,95.0,4109.0,0,pink
156,43759,22283,21476,215.0,11618.0,0,pink
157,42831,21955,20876,246.0,16354.0,0,pink
158,7249,3933,3316,43.0,2321.0,0,pink
159,8993,4553,4440,69.0,1789.0,0,pink
160,8440,4015,4425,49.0,2773.0,0,pink
161,7848,3916,3932,56.0,2059.0,0,pink
162,24106,12779,11327,126.0,6769.0,0,pink
163,10322,5138,5184,44.0,3037.0,0,pink
164,19034,10028,9006,109.0,5894.0,0,pink
165,10808,5462,5346,51.0,2988.0,0,pink
166,24054,12320,11734,144.0,10063.0,0,pink
167,20163,10335,9828,164.0,4648.0,0,pink
168,63644,32327,31317,241.0,20941.0,0,pink
169,8244,4124,4120,55.0,2421.0,0,pink
170,393463,204967,188496,1368.0,127532.0,0,pink
171,17603,8819,8784,116.0,6425.0,0,pink
172,118009,59979,58030,414.0,36993.0,0,pink
173,10442,5110,5332,52.0,2863.0,0,pink
174,7923,3942,3981,55.0,2569.0,0,pink
175,127461,65187,62274,608.0,39253.0,0,pink
176,17193,8586,8607,92.0,7121.0,0,pink
177,17043,8708,8335,132.0,5753.0,0,pink
178,26294,11853,14441,110.0,8558.0,0,pink
179,12446,6237,6209,83.0,3704.0,0,pink
180,39732,20400,19332,214.0,11260.0,0,pink
181,16684,8400,8284,66.0,4382.0,0,pink
182,228529,114348,114181,711.0,80619.0,0,pink
183,78804,40053,38751,348.0,27050.0,0,pink
184,6660,3609,3051,35.0,2293.0,0,pink
185,21573,10791,10782,125.0,7597.0,0,pink
186,1643700,836529,807171,2453.0,400735.0,1,purple
187,1146,534,612,0.0,158.0,0,pink
188,37829,17527,20302,104.0,11518.0,0,pink
189,227075,114562,112513,511.0,51809.0,0,pink
190,45235,22801,22434,151.0,9698.0,0,pink
191,21464,10340,11124,27.0,5333.0,0,pink
192,1133247,579546,553701,1626.0,293832.0,1,purple
193,27424,12849,14575,62.0,8500.0,0,pink
194,186661,93621,93040,256.0,39068.0,0,pink
195,978130,490194,487936,3022.0,328884.0,1,purple
196,27897,13726,14171,59.0,7804.0,0,pink
197,135768,68102,67666,176.0,29261.0,0,pink
198,180216,87966,92250,1026.0,89040.0,0,pink
199,18085,9001,9084,66.0,6079.0,0,pink
200,883053,430407,452646,2616.0,308788.0,1,purple
201,150075,67401,82674,520.0,67350.0,0,pink
202,64148,32269,31879,167.0,15002.0,0,pink
203,31185,10514,20671,67.0,11316.0,0,pink
204,10098052,5121264,4976788,35272.0,3691489.0,3,black
205,155013,80330,74683,407.0,55051.0,0,pink
206,260295,133182,127113,343.0,54750.0,0,pink
207,17540,8620,8920,42.0,4534.0,0,pink
208,87422,43983,43439,177.0,21693.0,0,pink
209,269075,133259,135816,916.0,89063.0,0,pink
210,8938,4325,4613,12.0,1352.0,0,pink
211,14174,6833,7341,11.0,3731.0,0,pink
212,433212,212245,220967,815.0,121059.0,1,purple
213,140530,70448,70082,188.0,35890.0,0,pink
214,99092,50203,48889,157.0,22484.0,0,pink
215,3164182,1601753,1562429,8014.0,783685.0,2,dark purple
216,380077,194566,185511,710.0,91103.0,0,pink
217,18699,9276,9423,18.0,4314.0,0,pink
218,2383286,1197098,1186188,6953.0,775517.0,2,dark purple
219,1510023,772281,737742,3781.0,409608.0,1,purple
220,59416,29790,29626,119.0,18790.0,0,pink
221,2135413,1072941,1062472,8456.0,743321.0,2,dark purple
222,3302833,1640902,1661931,5834.0,1062820.0,2,dark purple
223,870044,426074,443970,1193.0,209524.0,1,purple
224,732212,367600,364612,2499.0,230807.0,1,purple
225,281455,138686,142769,584.0,74492.0,0,pink
226,765935,388084,377851,1063.0,194296.0,1,purple
227,443738,221530,222208,798.0,119936.0,1,purple
228,1922200,951731,970469,3272.0,497405.0,2,dark purple
229,273765,138038,135727,327.0,72232.0,0,pink
230,179085,91226,87859,795.0,44970.0,0,pink
231,2930,1388,1542,6.0,390.0,0,pink
232,43540,21834,21706,99.0,9021.0,0,pink
233,438530,220599,217931,538.0,122401.0,1,purple
234,501317,256121,245196,633.0,119280.0,1,purple
235,539301,272457,266844,1957.0,168255.0,1,purple
236,95872,48083,47789,249.0,28367.0,0,pink
237,63373,31869,31504,232.0,17842.0,0,pink
238,12862,6280,6582,24.0,2017.0,0,pink
239,460477,230222,230255,1698.0,168044.0,1,purple
240,53932,25830,28102,220.0,17898.0,0,pink
241,848112,428524,419588,1705.0,238938.0,1,purple
242,214977,110602,104375,484.0,54914.0,0,pink
243,75493,37025,38468,157.0,21980.0,0,pink
244,497115,246411,250704,1465.0,165749.0,1,purple
245,16444,8202,8242,68.0,5917.0,0,pink
246,636671,321999,314672,1367.0,196452.0,1,purple
247,12908,6362,6546,24.0,3533.0,0,pink
248,3563,1808,1755,17.0,1025.0,0,pink
249,5809,2019,3790,50.0,3000.0,0,pink
250,321030,159675,161355,446.0,90872.0,0,pink
251,66120,33331,32789,132.0,18324.0,0,pink
252,19164,8896,10268,56.0,5657.0,0,pink
253,2039,1075,964,12.0,393.0,0,pink
254,9379,4563,4816,13.0,1928.0,0,pink
255,8142,4060,4082,58.0,2297.0,0,pink
256,3687,1746,1941,19.0,960.0,0,pink
257,5630,2104,3526,33.0,3560.0,0,pink
258,4640,2375,2265,23.0,837.0,0,pink
259,30346,15111,15235,160.0,7176.0,0,pink
260,693417,346229,347188,1521.0,224098.0,1,purple
261,1841,852,989,9.0,425.0,0,pink
262,328614,164848,163766,496.0,100813.0,0,pink
263,54357,25553,28804,39.0,18775.0,0,pink
264,688153,340675,347478,1894.0,236429.0,1,purple
265,25162,12441,12721,46.0,5821.0,0,pink
266,47002,19678,27324,209.0,18713.0,0,pink
267,58538,28759,29779,103.0,18007.0,0,pink
268,5924,2755,3169,7.0,1174.0,0,pink
269,15066,6937,8129,30.0,4066.0,0,pink
270,16537,7554,8983,16.0,3975.0,0,pink
271,878,472,406,0.0,160.0,0,pink
272,6583,3278,3305,40.0,1759.0,0,pink
273,1296,665,631,1.0,199.0,0,pink
274,570427,286508,283919,1547.0,160246.0,1,purple
275,1449,699,750,6.0,391.0,0,pink
276,7635,3477,4158,36.0,1881.0,0,pink
277,55101,27311,27790,99.0,15794.0,0,pink
278,7585,3409,4176,2.0,2201.0,0,pink
279,338161,169546,168615,598.0,108359.0,0,pink
280,14179,6727,7452,51.0,4391.0,0,pink
281,5548,2077,3471,11.0,2385.0,0,pink
282,21689,9981,11708,119.0,8644.0,0,pink
283,149998,75971,74027,637.0,51670.0,0,pink
284,823,421,402,4.0,303.0,0,pink
285,13060,6362,6698,59.0,3727.0,0,pink
286,25909,13149,12760,90.0,7641.0,0,pink
287,41268,20894,20374,184.0,11172.0,0,pink
288,28257,14145,14112,147.0,6942.0,0,pink
289,18325,9453,8872,137.0,5306.0,0,pink
290,4722,2410,2312,6.0,1115.0,0,pink
291,17392,8220,9172,25.0,3522.0,0,pink
292,4318,2023,2295,21.0,1114.0,0,pink
293,17909,8501,9408,9.0,8089.0,0,pink
294,12052,6017,6035,52.0,3220.0,0,pink
295,164685,83723,80962,878.0,61757.0,0,pink
296,6465,3174,3291,15.0,2230.0,0,pink
297,11351,5655,5696,47.0,3620.0,0,pink
298,24874,11959,12915,34.0,7856.0,0,pink
299,6468,3286,3182,12.0,1518.0,0,pink
300,544,261,283,0.0,317.0,0,pink
301,7968,3753,4215,8.0,2721.0,0,pink
302,2350,1188,1162,13.0,581.0,0,pink
303,30429,13745,16684,15.0,12068.0,0,pink
304,24113,11956,12157,67.0,5908.0,0,pink
305,4840,2330,2510,34.0,1258.0,0,pink
306,295123,146496,148627,777.0,105756.0,0,pink
307,10069,5050,5019,27.0,2331.0,0,pink
308,944348,484385,459963,3019.0,263806.0,1,purple
309,894730,460080,434650,3502.0,236395.0,1,purple
310,183031,92584,90447,549.0,41682.0,0,pink
311,163368,83692,79676,560.0,38751.0,0,pink
312,859339,445028,414311,3171.0,257123.0,1,purple
313,268881,134178,134703,783.0,73792.0,0,pink
314,151269,75448,75821,323.0,27848.0,0,pink
315,116538,58978,57560,364.0,31333.0,0,pink
316,174822,90551,84271,732.0,64567.0,0,pink
317,555133,286263,268870,1605.0,187783.0,1,purple
318,219540,113111,106429,995.0,78683.0,0,pink
319,263148,135850,127298,862.0,89102.0,0,pink
320,27785,13032,14753,165.0,10675.0,0,pink
321,182482,91714,90768,895.0,55929.0,0,pink
322,26979,12138,14841,180.0,9163.0,0,pink
323,576808,294785,282023,2534.0,174083.0,1,purple
324,1909151,979439,929712,6811.0,769484.0,2,dark purple
325,14444,6396,8048,121.0,4952.0,0,pink
326,176954,90676,86278,1060.0,48350.0,0,pink
327,143087,73711,69376,1182.0,38782.0,0,pink
328,207291,105066,102225,1028.0,66759.0,0,pink
329,363922,184586,179336,1167.0,105789.0,0,pink
330,69105,33422,35683,511.0,25556.0,0,pink
331,36399,15742,20657,192.0,11231.0,0,pink
332,16437,7219,9218,102.0,4913.0,0,pink
333,924229,476066,448163,4000.0,316891.0,1,purple
334,311522,157002,154520,1473.0,97483.0,0,pink
335,107139,55952,51187,477.0,28830.0,0,pink
336,11736,5022,6714,59.0,3571.0,0,pink
337,46017,24232,21785,266.0,17603.0,0,pink
338,17615,8366,9249,120.0,5653.0,0,pink
339,13363,6060,7303,39.0,2307.0,0,pink
340,16055,6469,9586,92.0,5021.0,0,pink
341,14269,5988,8281,67.0,4556.0,0,pink
342,27228,12523,14705,146.0,10290.0,0,pink
343,40127,18690,21437,183.0,13710.0,0,pink
344,182696,94949,87747,1369.0,53525.0,0,pink
345,102101,52374,49727,843.0,30600.0,0,pink
346,1378883,705597,673286,4643.0,476250.0,1,purple
347,19430,8946,10484,117.0,6357.0,0,pink
348,150984,78694,72290,785.0,42381.0,0,pink
349,48472,21688,26784,307.0,18184.0,0,pink
350,14105,6598,7507,71.0,5010.0,0,pink
351,8744,3678,5066,77.0,3152.0,0,pink
352,335362,172960,162402,1901.0,108629.0,0,pink
353,718679,366761,351918,2615.0,241240.0,1,purple
354,288102,151208,136894,816.0,113343.0,0,pink
355,39961,20597,19364,232.0,12688.0,0,pink
356,8365,3255,5110,33.0,3016.0,0,pink
357,18474,8645,9829,130.0,7019.0,0,pink
358,373853,193258,180595,1765.0,122725.0,0,pink
359,348371,181160,167211,2533.0,104875.0,0,pink
360,157581,79579,78002,774.0,41186.0,0,pink
361,2715516,1396889,1318627,12470.0,1538402.0,2,dark purple
362,76325,36503,39822,139.0,22784.0,0,pink
363,80578,40622,39956,364.0,27518.0,0,pink
364,200737,98992,101745,761.0,61768.0,0,pink
365,40572,18706,21866,219.0,12438.0,0,pink
366,1321194,672748,648446,3435.0,474938.0,1,purple
367,338619,171799,166820,1333.0,143583.0,0,pink
368,1446277,745070,701207,6017.0,504750.0,1,purple
369,510593,262021,248572,2306.0,158519.0,1,purple
370,957875,498109,459766,4109.0,274850.0,1,purple
371,668671,340965,327706,3543.0,258115.0,1,purple
372,72766,36925,35841,486.0,21110.0,0,pink
373,170442,83267,87175,697.0,58939.0,0,pink
374,412144,215711,196433,2106.0,121247.0,1,purple
375,455086,235151,219935,1318.0,131252.0,1,purple
376,235503,120843,114660,736.0,78437.0,0,pink
377,305591,156206,149385,1458.0,95318.0,0,pink
378,120999,60274,60725,744.0,29971.0,0,pink
379,43924,21694,22230,395.0,15885.0,0,pink
380,22098,9684,12414,123.0,8064.0,0,pink
381,15239,5320,9919,135.0,5167.0,0,pink
382,527634,270359,257275,2446.0,150269.0,1,purple
383,31877,14387,17490,147.0,12105.0,0,pink
384,65858,32541,33317,239.0,20484.0,0,pink
385,24566,11335,13231,128.0,7692.0,0,pink
386,18454,9101,9353,140.0,5445.0,0,pink
387,8265,4057,4208,59.0,2519.0,0,pink
388,11228,5664,5564,89.0,4344.0,0,pink
389,3189,1668,1521,19.0,693.0,0,pink
390,45286,22527,22759,269.0,11198.0,0,pink
391,18510,9229,9281,109.0,4606.0,0,pink
392,76887,39116,37771,302.0,26071.0,0,pink
393,103620,52288,51332,495.0,35317.0,0,pink
394,17154,9107,8047,128.0,4999.0,0,pink
395,19025,9726,9299,98.0,5877.0,0,pink
396,153490,81425,72065,853.0,45377.0,0,pink
397,12775,6838,5937,117.0,3979.0,0,pink
398,18561,9458,9103,119.0,4777.0,0,pink
399,15622,8014,7608,105.0,4076.0,0,pink
400,35885,18099,17786,120.0,11227.0,0,pink
401,74782,38005,36777,287.0,18185.0,0,pink
402,22550,11853,10697,129.0,6316.0,0,pink
403,23750,11089,12661,184.0,7713.0,0,pink
404,6428,2553,3875,34.0,1767.0,0,pink
405,52714,25695,27019,143.0,13655.0,0,pink
406,10827,5464,5363,114.0,2627.0,0,pink
407,116022,59574,56448,508.0,28358.0,0,pink
408,66299,34308,31991,208.0,16981.0,0,pink
409,12983,5461,7522,66.0,3540.0,0,pink
410,287049,148646,138403,1042.0,79505.0,0,pink
411,10767,3595,7172,29.0,7916.0,0,pink
412,24817,11952,12865,153.0,7575.0,0,pink
413,241910,122640,119270,723.0,75732.0,0,pink
414,124602,65354,59248,272.0,35250.0,0,pink
415,3001,1528,1473,9.0,644.0,0,pink
416,278666,147918,130748,1104.0,77839.0,0,pink
417,6743,3316,3427,46.0,2493.0,0,pink
418,745057,384787,360270,2103.0,216177.0,1,purple
419,42961,20873,22088,318.0,12393.0,0,pink
420,45606,23052,22554,281.0,13129.0,0,pink
421,147295,75325,71970,446.0,43187.0,0,pink
422,17184,8836,8348,89.0,5702.0,0,pink
423,140516,72086,68430,528.0,41142.0,0,pink
424,12344,6045,6299,65.0,2277.0,0,pink
425,22846,11997,10849,146.0,5589.0,0,pink
426,16227,8295,7932,46.0,3940.0,0,pink
427,23861,12087,11774,115.0,8348.0,0,pink
428,743187,391316,351871,1985.0,191797.0,1,purple
429,26833,13926,12907,147.0,9483.0,0,pink
430,20919,9947,10972,180.0,6000.0,0,pink
431,13905,6376,7529,85.0,2869.0,0,pink
432,91049,48905,42144,576.0,24387.0,0,pink
433,141840,74114,67726,477.0,43384.0,0,pink
434,10348,5557,4791,72.0,3187.0,0,pink
435,3994,2021,1973,12.0,1082.0,0,pink
436,58689,29474,29215,221.0,16436.0,0,pink
437,19212,10024,9188,125.0,5362.0,0,pink
438,22499,11394,11105,179.0,6813.0,0,pink
439,10727,5424,5303,73.0,2903.0,0,pink
440,24925,12839,12086,188.0,5788.0,0,pink
441,111369,57314,54055,392.0,29545.0,0,pink
442,96824,50014,46810,579.0,32038.0,0,pink
443,219880,110622,109258,475.0,66886.0,0,pink
444,22514,11661,10853,122.0,6182.0,0,pink
445,1021902,526815,495087,2680.0,275695.0,1,purple
446,29922,14843,15079,207.0,8254.0,0,pink
447,3009,1571,1438,32.0,737.0,0,pink
448,83974,44555,39419,448.0,27348.0,0,pink
449,56790,28789,28001,313.0,19731.0,0,pink
450,24926,12750,12176,121.0,6879.0,0,pink
451,16976,8677,8299,96.0,4768.0,0,pink
452,902298,461247,441051,2122.0,256861.0,1,purple
453,44289,23327,20962,313.0,11525.0,0,pink
454,195961,98443,97518,944.0,63487.0,0,pink
455,8535,3342,5193,93.0,1970.0,0,pink
456,28956,14915,14041,188.0,6282.0,0,pink
457,33590,16758,16832,127.0,7109.0,0,pink
458,25631,13073,12558,114.0,5619.0,0,pink
459,11677,5930,5747,62.0,2584.0,0,pink
460,221307,115548,105759,766.0,71819.0,0,pink
461,151682,77926,73756,550.0,49428.0,0,pink
462,9268,4510,4758,60.0,2231.0,0,pink
463,65755,33310,32445,332.0,24979.0,0,pink
464,13784,7102,6682,85.0,3803.0,0,pink
465,14991,7583,7408,83.0,4442.0,0,pink
466,15772,8167,7605,125.0,4242.0,0,pink
467,8827,4772,4055,71.0,1780.0,0,pink
468,9730,4412,5318,86.0,2685.0,0,pink
469,28548,14674,13874,129.0,6060.0,0,pink
470,18513,9554,8959,135.0,5843.0,0,pink
471,10366,5183,5183,34.0,2713.0,0,pink
472,47418,24921,22497,335.0,16433.0,0,pink
473,29348,14674,14674,123.0,8748.0,0,pink
474,62108,30558,31550,170.0,15743.0,0,pink
475,7799,4116,3683,42.0,1843.0,0,pink
476,18156,9284,8872,37.0,3578.0,0,pink
477,114582,58623,55959,444.0,36920.0,0,pink
478,31951,16400,15551,143.0,8930.0,0,pink
479,13480,6138,7342,56.0,2772.0,0,pink
480,28900,14392,14508,129.0,8039.0,0,pink
481,8484,4281,4203,60.0,1884.0,0,pink
482,21498,11499,9999,118.0,6162.0,0,pink
483,14120,7084,7036,42.0,2859.0,0,pink
484,21113,10892,10221,161.0,5567.0,0,pink
485,5836,3004,2832,34.0,2068.0,0,pink
486,22432,10749,11683,136.0,6303.0,0,pink
487,27010,13410,13600,192.0,7088.0,0,pink
488,9036,4403,4633,65.0,2382.0,0,pink
489,18235,9452,8783,75.0,5558.0,0,pink
490,39557,20035,19522,212.0,13522.0,0,pink
491,196670,100391,96279,929.0,45739.0,0,pink
492,106497,55899,50598,506.0,30688.0,0,pink
493,37017,18853,18164,129.0,10562.0,0,pink
494,14784,7388,7396,66.0,3768.0,0,pink
495,155840,79645,76195,486.0,46572.0,0,pink
496,26966,14014,12952,169.0,7958.0,0,pink
497,30832,15599,15233,203.0,10099.0,0,pink
498,19164,9525,9639,157.0,6610.0,0,pink
499,18082,9206,8876,113.0,6482.0,0,pink
500,41621,21206,20415,219.0,13735.0,0,pink
501,11295,6220,5075,86.0,2721.0,0,pink
502,21503,11101,10402,120.0,5291.0,0,pink
503,2276,1195,1081,5.0,574.0,0,pink
504,16457,8350,8107,110.0,4111.0,0,pink
505,7087,3594,3493,56.0,1839.0,0,pink
506,201463,104191,97272,992.0,60491.0,0,pink
507,89011,47067,41944,360.0,23696.0,0,pink
508,5211,2665,2546,13.0,1435.0,0,pink
509,13990,7186,6804,77.0,3192.0,0,pink
510,8437,4410,4027,41.0,2539.0,0,pink
511,64719,33324,31395,455.0,19273.0,0,pink
512,25676,13911,11765,191.0,7287.0,0,pink
513,6042,2148,3894,36.0,3302.0,0,pink
514,30352,15993,14359,192.0,8735.0,0,pink
515,6378,3346,3032,39.0,1393.0,0,pink
516,1665,818,847,4.0,355.0,0,pink
517,25353,10465,14888,150.0,5880.0,0,pink
518,8193,4247,3946,58.0,2446.0,0,pink
519,16115,6769,9346,94.0,3559.0,0,pink
520,8859,4631,4228,74.0,2565.0,0,pink
521,44730,23511,21219,240.0,13800.0,0,pink
522,40510,21001,19509,242.0,13825.0,0,pink
523,27048,14557,12491,229.0,8093.0,0,pink
524,11417,6083,5334,129.0,3095.0,0,pink
525,6777,3204,3573,73.0,1913.0,0,pink
526,69774,36387,33387,432.0,18736.0,0,pink
527,7962,4119,3843,67.0,3190.0,0,pink
528,8284,4216,4068,77.0,1894.0,0,pink
529,22775,11727,11048,235.0,7641.0,0,pink
530,26216,13713,12503,262.0,9640.0,0,pink
531,68824,34742,34082,303.0,19934.0,0,pink
532,90132,46357,43775,488.0,26613.0,0,pink
533,35599,17846,17753,319.0,11509.0,0,pink
534,5346,2871,2475,36.0,1306.0,0,pink
535,20461,10100,10361,150.0,5163.0,0,pink
536,29767,14716,15051,233.0,8926.0,0,pink
537,2613,1359,1254,11.0,553.0,0,pink
538,7939,2932,5007,45.0,1625.0,0,pink
539,28928,14800,14128,192.0,8302.0,0,pink
540,103849,52324,51525,504.0,39195.0,0,pink
541,8846,3604,5242,77.0,2435.0,0,pink
542,9884,5114,4770,58.0,2632.0,0,pink
543,9078,4729,4349,71.0,2723.0,0,pink
544,20656,10616,10040,136.0,5565.0,0,pink
545,197658,99382,98276,234.0,42407.0,0,pink
546,987638,489992,497646,1344.0,263170.0,1,purple
547,75,37,38,0.0,3.0,0,pink
548,71377,36002,35375,49.0,19078.0,0,pink
549,165281,82844,82437,186.0,45363.0,0,pink
550,446052,222685,223367,1145.0,160479.0,1,purple
551,4019,1926,2093,18.0,831.0,0,pink
552,85065,42765,42300,277.0,24505.0,0,pink
553,5962,3064,2898,19.0,1146.0,0,pink
554,9086,4479,4607,45.0,2784.0,0,pink
555,45551,22805,22746,177.0,11180.0,0,pink
556,21994,10743,11251,36.0,7315.0,0,pink
557,7163,3383,3780,14.0,1334.0,0,pink
558,42711,21345,21366,201.0,10286.0,0,pink
559,112397,56160,56237,317.0,35743.0,0,pink
560,11549,5814,5735,70.0,2433.0,0,pink
561,2602,1260,1342,12.0,560.0,0,pink
562,886,453,433,2.0,184.0,0,pink
563,212230,107328,104902,744.0,70791.0,0,pink
564,6918,3375,3543,38.0,1670.0,0,pink
565,23615,11576,12039,62.0,5623.0,0,pink
566,1077,507,570,1.0,118.0,0,pink
567,8640,3850,4790,40.0,2693.0,0,pink
568,4141,1976,2165,9.0,714.0,0,pink
569,26433,12575,13858,74.0,9069.0,0,pink
570,13279,6492,6787,31.0,2595.0,0,pink
571,12965,6199,6766,30.0,2514.0,0,pink
572,17052,8698,8354,90.0,4271.0,0,pink
573,15169,7258,7911,67.0,3989.0,0,pink
574,16337,7800,8537,59.0,3629.0,0,pink
575,27969,13674,14295,70.0,6891.0,0,pink
576,23431,11630,11801,71.0,7141.0,0,pink
577,153605,77715,75890,678.0,47262.0,0,pink
578,39239,19345,19894,57.0,7722.0,0,pink
579,7798,3850,3948,28.0,1786.0,0,pink
580,3845,1934,1911,32.0,1413.0,0,pink
581,5321,2555,2766,15.0,1317.0,0,pink
582,38705,19176,19529,60.0,13858.0,0,pink
583,20615,10238,10377,72.0,4824.0,0,pink
584,40155,20397,19758,165.0,10626.0,0,pink
585,4326,2243,2083,12.0,965.0,0,pink
586,11455,5581,5874,57.0,2624.0,0,pink
587,23041,11571,11470,95.0,6785.0,0,pink
588,7713,3932,3781,20.0,1664.0,0,pink
589,12526,6259,6267,80.0,3122.0,0,pink
590,11080,5193,5887,10.0,2965.0,0,pink
591,83666,42462,41204,324.0,28740.0,0,pink
592,10401,4915,5486,19.0,3161.0,0,pink
593,10025,5059,4966,61.0,2639.0,0,pink
594,66427,33946,32481,234.0,27806.0,0,pink
595,6532,3428,3104,16.0,1584.0,0,pink
596,16712,8125,8587,35.0,5328.0,0,pink
597,53606,26776,26830,132.0,17479.0,0,pink
598,6675,2437,4238,17.0,2891.0,0,pink
599,33381,16944,16437,139.0,10232.0,0,pink
600,4858,2423,2435,6.0,1906.0,0,pink
601,14562,7333,7229,57.0,5029.0,0,pink
602,12665,6312,6353,38.0,5633.0,0,pink
603,209448,104935,104513,322.0,85414.0,0,pink
604,33231,16413,16818,119.0,12986.0,0,pink
605,15836,8012,7824,57.0,5928.0,0,pink
606,13338,6752,6586,76.0,5912.0,0,pink
607,37628,18077,19551,120.0,14301.0,0,pink
608,51736,26737,24999,189.0,18885.0,0,pink
609,5223719,2689079,2534640,15252.0,1520321.0,2,dark purple
610,19088,9178,9910,52.0,7852.0,0,pink
611,10865,5410,5455,42.0,4006.0,0,pink
612,16042,8027,8015,41.0,5211.0,0,pink
613,104200,52620,51580,219.0,32365.0,0,pink
614,19714,9966,9748,66.0,8217.0,0,pink
615,931743,474565,457178,1877.0,287581.0,1,purple
616,17539,8922,8617,60.0,6604.0,0,pink
617,6507,3276,3231,29.0,2193.0,0,pink
618,34174,17203,16971,148.0,12816.0,0,pink
619,21724,10144,11580,105.0,8728.0,0,pink
620,13398,6782,6616,71.0,5485.0,0,pink
621,39127,19842,19285,186.0,15421.0,0,pink
622,35418,16922,18496,141.0,12789.0,0,pink
623,5157,2685,2472,20.0,1853.0,0,pink
624,13218,6550,6668,49.0,4284.0,0,pink
625,50509,25268,25241,154.0,16200.0,0,pink
626,8221,4203,4018,33.0,2813.0,0,pink
627,18112,9104,9008,52.0,5379.0,0,pink
628,4009,2033,1976,20.0,1455.0,0,pink
629,6884,3515,3369,19.0,1616.0,0,pink
630,49464,24928,24536,136.0,15812.0,0,pink
631,28169,14418,13751,131.0,8818.0,0,pink
632,58551,29562,28989,148.0,20049.0,0,pink
633,9598,4789,4809,36.0,3231.0,0,pink
634,38169,18602,19567,186.0,13501.0,0,pink
635,22069,11228,10841,81.0,7825.0,0,pink
636,21834,10878,10956,46.0,5151.0,0,pink
637,12602,5587,7015,45.0,5581.0,0,pink
638,530839,266628,264211,1223.0,165000.0,1,purple
639,111061,56446,54615,390.0,36560.0,0,pink
640,124626,62865,61761,180.0,41545.0,0,pink
641,50999,25256,25743,247.0,16149.0,0,pink
642,110401,55001,55400,420.0,36863.0,0,pink
643,703619,352276,351343,1543.0,209102.0,1,purple
644,16189,7270,8919,45.0,6862.0,0,pink
645,34527,16201,18326,96.0,11533.0,0,pink
646,36324,17710,18614,148.0,13104.0,0,pink
647,29207,15024,14183,100.0,12602.0,0,pink
648,106512,55450,51062,375.0,39976.0,0,pink
649,45719,23117,22602,150.0,15996.0,0,pink
650,265670,135952,129718,859.0,87045.0,0,pink
651,38084,19358,18726,226.0,14546.0,0,pink
652,11794,5920,5874,35.0,3482.0,0,pink
653,13778,6940,6838,66.0,4728.0,0,pink
654,14430,7636,6794,73.0,4648.0,0,pink
655,30875,15866,15009,109.0,9019.0,0,pink
656,307789,154407,153382,535.0,97659.0,0,pink
657,173219,88974,84245,338.0,63824.0,0,pink
658,12367,6324,6043,29.0,4577.0,0,pink
659,15693,7895,7798,52.0,4914.0,0,pink
660,33936,17245,16691,142.0,11537.0,0,pink
661,29009,13864,15145,114.0,12165.0,0,pink
662,34426,17128,17298,140.0,12253.0,0,pink
663,14703,7531,7172,55.0,4922.0,0,pink
664,51328,25714,25614,140.0,17430.0,0,pink
665,184463,95076,89387,581.0,59503.0,0,pink
666,21384,9617,11767,103.0,9106.0,0,pink
667,16427,8347,8080,23.0,5570.0,0,pink
668,15754,7939,7815,70.0,6152.0,0,pink
669,4249,1900,2349,9.0,1269.0,0,pink
670,5611,2864,2747,24.0,2073.0,0,pink
671,5746,2787,2959,11.0,1429.0,0,pink
672,32546,14527,18019,135.0,12896.0,0,pink
673,15881,8072,7809,78.0,6290.0,0,pink
674,145275,73679,71596,521.0,42109.0,0,pink
675,24231,12269,11962,106.0,10302.0,0,pink
676,197661,102785,94876,449.0,75987.0,0,pink
677,7064,3363,3701,18.0,2492.0,0,pink
678,5047,2587,2460,14.0,1580.0,0,pink
679,21832,11041,10791,83.0,7604.0,0,pink
680,263463,136226,127237,804.0,80780.0,0,pink
681,5500,2784,2716,39.0,1898.0,0,pink
682,45433,23447,21986,189.0,14921.0,0,pink
683,133852,67865,65987,517.0,45908.0,0,pink
684,17127,8535,8592,69.0,6859.0,0,pink
685,78407,39440,38967,322.0,35075.0,0,pink
686,11573,5907,5666,30.0,4903.0,0,pink
687,17338,8985,8353,95.0,5052.0,0,pink
688,14155,7047,7108,37.0,4136.0,0,pink
689,16487,8346,8141,94.0,6611.0,0,pink
690,14025,7143,6882,56.0,5439.0,0,pink
691,56396,28597,27799,244.0,19386.0,0,pink
692,688697,346881,341816,1693.0,215372.0,1,purple
693,67299,33692,33607,276.0,28748.0,0,pink
694,286174,146426,139748,905.0,100064.0,0,pink
695,38817,19474,19343,122.0,12545.0,0,pink
696,35195,17634,17561,122.0,8718.0,0,pink
697,370016,189347,180669,1321.0,123852.0,0,pink
698,81893,40743,41150,278.0,26736.0,0,pink
699,8667,4341,4326,29.0,3031.0,0,pink
700,12129,6092,6037,87.0,3697.0,0,pink
701,64321,32571,31750,218.0,17370.0,0,pink
702,15034,7593,7441,65.0,2987.0,0,pink
703,19994,9960,10034,82.0,4916.0,0,pink
704,38084,19002,19082,188.0,14079.0,0,pink
705,115702,59343,56359,453.0,41028.0,0,pink
706,26268,13333,12935,105.0,8155.0,0,pink
707,32301,16315,15986,155.0,10610.0,0,pink
708,10581,5214,5367,46.0,3088.0,0,pink
709,32937,16303,16634,170.0,9062.0,0,pink
710,42704,21397,21307,169.0,13660.0,0,pink
711,49501,24737,24764,192.0,16275.0,0,pink
712,26552,13350,13202,168.0,8558.0,0,pink
713,115616,59873,55743,517.0,30099.0,0,pink
714,42418,21370,21048,184.0,15027.0,0,pink
715,203604,102891,100713,835.0,61282.0,0,pink
716,23259,11785,11474,169.0,8326.0,0,pink
717,76809,39674,37135,343.0,24090.0,0,pink
718,16486,8235,8251,116.0,6413.0,0,pink
719,22842,11416,11426,96.0,5192.0,0,pink
720,20212,10250,9962,118.0,5774.0,0,pink
721,33596,16748,16848,167.0,14337.0,0,pink
722,66944,35009,31935,406.0,20959.0,0,pink
723,32295,16262,16033,160.0,9060.0,0,pink
724,316095,161563,154532,768.0,96647.0,0,pink
725,73830,37575,36255,315.0,25222.0,0,pink
726,39712,19837,19875,176.0,13304.0,0,pink
727,160940,80549,80391,660.0,47668.0,0,pink
728,48483,23092,25391,262.0,16152.0,0,pink
729,82387,42535,39852,507.0,29991.0,0,pink
730,36378,18503,17875,180.0,14384.0,0,pink
731,43938,22116,21822,150.0,15134.0,0,pink
732,33449,16750,16699,173.0,11052.0,0,pink
733,20993,10595,10398,94.0,5843.0,0,pink
734,32237,16904,15333,189.0,11215.0,0,pink
735,27727,13802,13925,129.0,8150.0,0,pink
736,151564,77215,74349,695.0,50866.0,0,pink
737,37409,18460,18949,210.0,14172.0,0,pink
738,78806,39542,39264,265.0,22863.0,0,pink
739,38942,19190,19752,115.0,6538.0,0,pink
740,110552,53484,57068,411.0,31695.0,0,pink
741,486849,251334,235515,2086.0,133875.0,1,purple
742,45619,23061,22558,289.0,14462.0,0,pink
743,129505,64798,64707,741.0,39551.0,0,pink
744,944523,489516,455007,3336.0,267723.0,1,purple
745,46595,23421,23174,228.0,14054.0,0,pink
746,10210,5055,5155,33.0,2663.0,0,pink
747,35901,16817,19084,183.0,10884.0,0,pink
748,145403,72987,72416,331.0,34351.0,0,pink
749,38276,18834,19442,178.0,12282.0,0,pink
750,69727,35280,34447,324.0,19554.0,0,pink
751,14018,7014,7004,78.0,3090.0,0,pink
752,47451,23607,23844,182.0,15710.0,0,pink
753,5887,2969,2918,27.0,1766.0,0,pink
754,19547,9820,9727,111.0,5928.0,0,pink
755,20878,10250,10628,140.0,6894.0,0,pink
756,16996,8785,8211,62.0,4353.0,0,pink
757,19141,8919,10222,81.0,5895.0,0,pink
758,12411,6155,6256,57.0,4501.0,0,pink
759,168041,84829,83212,652.0,47514.0,0,pink
760,25589,12802,12787,64.0,7889.0,0,pink
761,12660,6256,6404,95.0,3550.0,0,pink
762,37559,17845,19714,145.0,11171.0,0,pink
763,25076,12807,12269,166.0,7019.0,0,pink
764,28425,14348,14077,162.0,10078.0,0,pink
765,16704,8519,8185,62.0,6103.0,0,pink
766,23743,12073,11670,122.0,9438.0,0,pink
767,44399,22458,21941,217.0,17063.0,0,pink
768,20526,10163,10363,66.0,6151.0,0,pink
769,269240,138408,130832,989.0,84547.0,0,pink
770,22941,11639,11302,114.0,5626.0,0,pink
771,34474,16932,17542,131.0,11456.0,0,pink
772,20792,9618,11174,87.0,6391.0,0,pink
773,10628,5124,5504,31.0,2674.0,0,pink
774,189294,92428,96866,472.0,60747.0,0,pink
775,15218,7609,7609,100.0,3986.0,0,pink
776,7153,3639,3514,30.0,2349.0,0,pink
777,181313,93637,87676,706.0,70634.0,0,pink
778,15560,7751,7809,82.0,4913.0,0,pink
779,107693,52988,54705,463.0,35039.0,0,pink
780,31631,16266,15365,172.0,10405.0,0,pink
781,8247,4123,4124,31.0,2382.0,0,pink
782,61928,31519,30409,268.0,24798.0,0,pink
783,27827,13935,13892,102.0,7167.0,0,pink
784,66613,34325,32288,368.0,23365.0,0,pink
785,27947,14174,13773,149.0,7556.0,0,pink
786,24217,12074,12143,103.0,8231.0,0,pink
787,33649,16947,16702,97.0,11407.0,0,pink
788,7124,3608,3516,53.0,1807.0,0,pink
789,3726,1872,1854,15.0,947.0,0,pink
790,13880,6835,7045,67.0,3257.0,0,pink
791,12510,6356,6154,81.0,3458.0,0,pink
792,5637,2879,2758,26.0,1365.0,0,pink
793,25626,12843,12783,82.0,7226.0,0,pink
794,133009,67700,65309,526.0,38807.0,0,pink
795,26399,13089,13310,70.0,6517.0,0,pink
796,24782,12508,12274,89.0,6358.0,0,pink
797,21125,10674,10451,68.0,5525.0,0,pink
798,20260,10022,10238,66.0,7029.0,0,pink
799,14735,7354,7381,64.0,3805.0,0,pink
800,9780,4736,5044,27.0,3100.0,0,pink
801,20344,10356,9988,88.0,5707.0,0,pink
802,13191,6644,6547,88.0,3358.0,0,pink
803,18445,9284,9161,49.0,5045.0,0,pink
804,42984,22134,20850,184.0,12782.0,0,pink
805,11468,5672,5796,75.0,3612.0,0,pink
806,12099,6041,6058,37.0,3159.0,0,pink
807,9282,4593,4689,43.0,2701.0,0,pink
808,16313,8262,8051,53.0,4810.0,0,pink
809,17672,8772,8900,80.0,4043.0,0,pink
810,47218,24092,23126,172.0,13830.0,0,pink
811,17132,8585,8547,60.0,5137.0,0,pink
812,84002,42635,41367,163.0,26807.0,0,pink
813,8885,4487,4398,38.0,1836.0,0,pink
814,8044,4027,4017,29.0,1848.0,0,pink
815,17258,8569,8689,73.0,4767.0,0,pink
816,39600,20287,19313,166.0,11270.0,0,pink
817,17056,8541,8515,82.0,4800.0,0,pink
818,96802,49058,47744,332.0,30900.0,0,pink
819,9551,4781,4770,59.0,2693.0,0,pink
820,19929,9931,9998,88.0,4939.0,0,pink
821,15858,8092,7766,71.0,4195.0,0,pink
822,10245,5128,5117,57.0,2960.0,0,pink
823,6968,3498,3470,30.0,1651.0,0,pink
824,9003,4623,4380,28.0,2055.0,0,pink
825,12341,6233,6108,50.0,3061.0,0,pink
826,10674,5339,5335,48.0,2769.0,0,pink
827,15110,7733,7377,91.0,4026.0,0,pink
828,10888,5394,5494,52.0,3327.0,0,pink
829,17127,8562,8565,72.0,5071.0,0,pink
830,14143,7154,6989,101.0,3857.0,0,pink
831,19926,9801,10125,85.0,6525.0,0,pink
832,9264,4684,4580,37.0,2318.0,0,pink
833,9566,4915,4651,44.0,3101.0,0,pink
834,6916,3459,3457,51.0,2171.0,0,pink
835,16207,8155,8052,54.0,4379.0,0,pink
836,19395,9683,9712,75.0,5515.0,0,pink
837,36891,18222,18669,125.0,10413.0,0,pink
838,18077,8965,9112,62.0,4397.0,0,pink
839,147001,74236,72765,183.0,44843.0,0,pink
840,20568,9983,10585,84.0,6460.0,0,pink
841,10200,4998,5202,55.0,2524.0,0,pink
842,15075,7528,7547,98.0,4359.0,0,pink
843,34541,17170,17371,151.0,9196.0,0,pink
844,222121,112581,109540,664.0,64520.0,0,pink
845,11223,5499,5724,67.0,2981.0,0,pink
846,8597,4279,4318,34.0,2189.0,0,pink
847,11769,5756,6013,55.0,3152.0,0,pink
848,15890,7862,8028,45.0,3704.0,0,pink
849,22208,10956,11252,97.0,5821.0,0,pink
850,33207,16833,16374,134.0,8882.0,0,pink
851,40271,19871,20400,134.0,11398.0,0,pink
852,14957,7441,7516,48.0,4021.0,0,pink
853,10631,5349,5282,52.0,2836.0,0,pink
854,8796,4513,4283,54.0,2101.0,0,pink
855,7863,3799,4064,52.0,2204.0,0,pink
856,10155,5286,4869,60.0,2596.0,0,pink
857,42950,21474,21476,151.0,11232.0,0,pink
858,13911,6949,6962,73.0,3888.0,0,pink
859,6115,3024,3091,24.0,1579.0,0,pink
860,15363,7441,7922,56.0,3845.0,0,pink
861,9055,4543,4512,45.0,2434.0,0,pink
862,25039,12751,12288,118.0,7138.0,0,pink
863,6898,3514,3384,33.0,1970.0,0,pink
864,474274,240675,233599,1223.0,147032.0,1,purple
865,93503,47580,45923,363.0,27892.0,0,pink
866,18605,9615,8990,65.0,4634.0,0,pink
867,4984,2552,2432,42.0,1334.0,0,pink
868,9868,5050,4818,44.0,2897.0,0,pink
869,172288,87773,84515,446.0,48752.0,0,pink
870,11694,5959,5735,60.0,3233.0,0,pink
871,34825,17338,17487,97.0,8937.0,0,pink
872,96922,46438,50484,107.0,23254.0,0,pink
873,17136,8639,8497,101.0,4651.0,0,pink
874,6201,3033,3168,25.0,1541.0,0,pink
875,12453,6390,6063,56.0,3196.0,0,pink
876,7223,3525,3698,28.0,1727.0,0,pink
877,35315,17912,17403,222.0,10424.0,0,pink
878,49361,25243,24118,157.0,14486.0,0,pink
879,22143,11068,11075,89.0,6861.0,0,pink
880,6413,3256,3157,36.0,1527.0,0,pink
881,36757,17785,18972,187.0,12318.0,0,pink
882,10571,5381,5190,48.0,3466.0,0,pink
883,20401,10245,10156,57.0,4521.0,0,pink
884,102398,51902,50496,363.0,33045.0,0,pink
885,7489,3735,3754,17.0,2060.0,0,pink
886,12804,6421,6383,71.0,4069.0,0,pink
887,12630,6349,6281,95.0,5116.0,0,pink
888,7852,3920,3932,40.0,2582.0,0,pink
889,16363,8414,7949,49.0,5158.0,0,pink
890,4733,2377,2356,14.0,1236.0,0,pink
891,26791,13429,13362,130.0,7680.0,0,pink
892,14702,7459,7243,66.0,5596.0,0,pink
893,9664,4979,4685,56.0,3164.0,0,pink
894,66468,32929,33539,244.0,22523.0,0,pink
895,2645,1305,1340,13.0,834.0,0,pink
896,3367,1610,1757,23.0,997.0,0,pink
897,20331,10333,9998,106.0,7392.0,0,pink
898,2677,1357,1320,17.0,742.0,0,pink
899,2053,1016,1037,8.0,591.0,0,pink
900,8142,4064,4078,52.0,2509.0,0,pink
901,9060,4537,4523,55.0,2672.0,0,pink
902,8296,4101,4195,50.0,2828.0,0,pink
903,1780,868,912,21.0,561.0,0,pink
904,35591,17676,17915,181.0,12448.0,0,pink
905,39108,19581,19527,159.0,15106.0,0,pink
906,2881,1462,1419,22.0,800.0,0,pink
907,19004,9449,9555,110.0,5884.0,0,pink
908,7736,3776,3960,40.0,2841.0,0,pink
909,119319,60252,59067,189.0,34088.0,0,pink
910,2925,1431,1494,17.0,716.0,0,pink
911,2562,1304,1258,13.0,702.0,0,pink
912,28878,14484,14394,97.0,8413.0,0,pink
913,6293,2639,3654,37.0,2465.0,0,pink
914,36957,18017,18940,137.0,13680.0,0,pink
915,34484,16588,17896,127.0,12407.0,0,pink
916,25563,12996,12567,109.0,8195.0,0,pink
917,34895,16355,18540,96.0,11411.0,0,pink
918,2619,1321,1298,27.0,951.0,0,pink
919,2545,1255,1290,20.0,761.0,0,pink
920,7616,3628,3988,41.0,2850.0,0,pink
921,6037,3012,3025,29.0,1463.0,0,pink
922,1200,619,581,6.0,398.0,0,pink
923,6156,3050,3106,33.0,2248.0,0,pink
924,2616,1263,1353,7.0,558.0,0,pink
925,5673,2789,2884,32.0,1930.0,0,pink
926,34555,17355,17200,149.0,12004.0,0,pink
927,4047,2041,2006,17.0,1154.0,0,pink
928,1842,901,941,13.0,505.0,0,pink
929,13318,6676,6642,42.0,4629.0,0,pink
930,18888,9307,9581,78.0,5732.0,0,pink
931,2916,1434,1482,17.0,965.0,0,pink
932,585502,298515,286987,1430.0,177211.0,1,purple
933,3932,1998,1934,24.0,1568.0,0,pink
934,7470,3721,3749,31.0,2334.0,0,pink
935,2526,1292,1234,9.0,789.0,0,pink
936,20367,10297,10070,89.0,8007.0,0,pink
937,1642,792,850,12.0,392.0,0,pink
938,80042,37109,42933,229.0,24114.0,0,pink
939,3097,1512,1585,12.0,737.0,0,pink
940,9635,4835,4800,38.0,3465.0,0,pink
941,2810,1412,1398,16.0,1034.0,0,pink
942,33299,17039,16260,140.0,12114.0,0,pink
943,12032,6061,5971,59.0,4035.0,0,pink
944,9798,4874,4924,53.0,3030.0,0,pink
945,28630,14471,14159,151.0,9506.0,0,pink
946,4261,2132,2129,29.0,1434.0,0,pink
947,33127,16743,16384,108.0,9604.0,0,pink
948,6222,3059,3163,30.0,1764.0,0,pink
949,32970,16560,16410,185.0,10988.0,0,pink
950,5566,2813,2753,41.0,1770.0,0,pink
951,2838,1389,1449,14.0,748.0,0,pink
952,10104,4985,5119,69.0,3793.0,0,pink
953,16125,8202,7923,84.0,6110.0,0,pink
954,2955,1462,1493,19.0,902.0,0,pink
955,5486,2450,3036,42.0,2466.0,0,pink
956,15882,7914,7968,72.0,4865.0,0,pink
957,3603,1796,1807,21.0,1017.0,0,pink
958,5902,2859,3043,26.0,1458.0,0,pink
959,6709,2940,3769,29.0,2662.0,0,pink
960,5408,2760,2648,33.0,1696.0,0,pink
961,23545,11799,11746,73.0,7080.0,0,pink
962,9582,4797,4785,40.0,2282.0,0,pink
963,2509,1223,1286,14.0,782.0,0,pink
964,63101,31326,31775,290.0,22642.0,0,pink
965,4686,2415,2271,25.0,1557.0,0,pink
966,9762,4918,4844,34.0,3077.0,0,pink
967,75296,35387,39909,118.0,16613.0,0,pink
968,5118,2649,2469,23.0,1605.0,0,pink
969,3102,1581,1521,24.0,1007.0,0,pink
970,6977,3525,3452,47.0,2171.0,0,pink
971,54977,27602,27375,289.0,17018.0,0,pink
972,4949,2489,2460,41.0,1585.0,0,pink
973,512064,258863,253201,1736.0,171096.0,1,purple
974,22692,11091,11601,82.0,8626.0,0,pink
975,178284,91957,86327,752.0,60330.0,0,pink
976,2506,1231,1275,21.0,904.0,0,pink
977,5966,2963,3003,23.0,1817.0,0,pink
978,3663,1854,1809,10.0,835.0,0,pink
979,4214,2057,2157,33.0,1389.0,0,pink
980,2063,1008,1055,14.0,566.0,0,pink
981,5686,2804,2882,27.0,1902.0,0,pink
982,23208,11627,11581,87.0,6622.0,0,pink
983,7824,4008,3816,32.0,3007.0,0,pink
984,2858,1408,1450,16.0,952.0,0,pink
985,6888,3391,3497,25.0,2005.0,0,pink
986,1575,785,790,8.0,488.0,0,pink
987,5525,2681,2844,29.0,1614.0,0,pink
988,2143,1124,1019,11.0,617.0,0,pink
989,8780,4462,4318,63.0,3452.0,0,pink
990,3170,1587,1583,18.0,1046.0,0,pink
991,164345,83051,81294,545.0,54412.0,0,pink
992,19241,9716,9525,116.0,7813.0,0,pink
993,20794,10455,10339,127.0,8519.0,0,pink
994,22214,11341,10873,79.0,8492.0,0,pink
995,8090,4098,3992,38.0,1747.0,0,pink
996,43680,22515,21165,240.0,17229.0,0,pink
997,12268,6172,6096,53.0,4649.0,0,pink
998,27188,13863,13325,172.0,11113.0,0,pink
999,129095,65034,64061,352.0,46832.0,0,pink
1000,20144,10474,9670,76.0,7816.0,0,pink
1001,48091,24133,23958,209.0,22793.0,0,pink
1002,29913,15010,14903,166.0,11603.0,0,pink
1003,8306,4123,4183,29.0,2779.0,0,pink
1004,13116,6539,6577,72.0,5399.0,0,pink
1005,20080,9992,10088,89.0,6718.0,0,pink
1006,79466,39839,39627,262.0,29607.0,0,pink
1007,12745,6333,6412,58.0,4769.0,0,pink
1008,12727,6559,6168,67.0,5450.0,0,pink
1009,38776,19958,18818,107.0,11787.0,0,pink
1010,92267,47143,45124,215.0,30049.0,0,pink
1011,4841,2497,2344,24.0,1363.0,0,pink
1012,10711,5256,5455,55.0,4348.0,0,pink
1013,27290,13853,13437,122.0,12029.0,0,pink
1014,15796,8058,7738,85.0,5449.0,0,pink
1015,72263,33852,38411,235.0,20099.0,0,pink
1016,35872,18299,17573,84.0,14452.0,0,pink
1017,20621,9794,10827,110.0,9739.0,0,pink
1018,10211,5127,5084,58.0,4777.0,0,pink
1019,9083,4490,4593,57.0,2859.0,0,pink
1020,6713,3424,3289,35.0,2798.0,0,pink
1021,99937,51195,48742,446.0,38693.0,0,pink
1022,12122,6029,6093,57.0,3293.0,0,pink
1023,7517,3232,4285,22.0,3709.0,0,pink
1024,14313,7209,7104,58.0,5291.0,0,pink
1025,318734,162281,156453,731.0,122633.0,0,pink
1026,14479,7333,7146,76.0,5022.0,0,pink
1027,36926,18856,18070,255.0,16903.0,0,pink
1028,50296,25906,24390,195.0,18548.0,0,pink
1029,6210,3108,3102,35.0,1488.0,0,pink
1030,8703,4230,4473,58.0,2831.0,0,pink
1031,17328,8853,8475,92.0,6007.0,0,pink
1032,24915,12597,12318,75.0,9954.0,0,pink
1033,37294,18946,18348,205.0,13682.0,0,pink
1034,26178,13105,13073,155.0,10237.0,0,pink
1035,11023,5630,5393,51.0,4862.0,0,pink
1036,35765,18354,17411,160.0,16704.0,0,pink
1037,8719,4225,4494,30.0,3149.0,0,pink
1038,108095,54372,53723,491.0,43653.0,0,pink
1039,27134,14002,13132,235.0,12791.0,0,pink
1040,18668,9522,9146,91.0,8543.0,0,pink
1041,18627,9461,9166,111.0,6904.0,0,pink
1042,46137,23809,22328,185.0,17665.0,0,pink
1043,15814,8001,7813,68.0,6417.0,0,pink
1044,4568,2435,2133,31.0,1121.0,0,pink
1045,45664,23445,22219,284.0,19669.0,0,pink
1046,13373,6718,6655,85.0,5222.0,0,pink
1047,767154,396310,370844,2668.0,282271.0,1,purple
1048,52422,26943,25479,170.0,19109.0,0,pink
1049,22843,11643,11200,138.0,9051.0,0,pink
1050,164688,83258,81430,476.0,54021.0,0,pink
1051,15513,7820,7693,77.0,6087.0,0,pink
1052,31467,16137,15330,173.0,15219.0,0,pink
1053,14156,7129,7027,81.0,4861.0,0,pink
1054,60180,30768,29412,287.0,27072.0,0,pink
1055,15783,7885,7898,80.0,5596.0,0,pink
1056,6751,3250,3501,59.0,3523.0,0,pink
1057,10472,5405,5067,60.0,5228.0,0,pink
1058,22676,11589,11087,146.0,9856.0,0,pink
1059,13490,6776,6714,94.0,5754.0,0,pink
1060,24458,12477,11981,150.0,8936.0,0,pink
1061,9263,4637,4626,69.0,3111.0,0,pink
1062,26849,13695,13154,139.0,10326.0,0,pink
1063,8186,3690,4496,42.0,3754.0,0,pink
1064,89700,45963,43737,319.0,35372.0,0,pink
1065,12666,6318,6348,63.0,5162.0,0,pink
1066,19232,9481,9751,93.0,8058.0,0,pink
1067,31166,15825,15341,129.0,10245.0,0,pink
1068,11919,5336,6583,54.0,4247.0,0,pink
1069,17153,8668,8485,117.0,6312.0,0,pink
1070,65284,34091,31193,311.0,24247.0,0,pink
1071,17635,8022,9613,91.0,7751.0,0,pink
1072,9331,4729,4602,62.0,3352.0,0,pink
1073,28326,13974,14352,69.0,7471.0,0,pink
1074,6405,2984,3421,36.0,2372.0,0,pink
1075,21516,10919,10597,120.0,9521.0,0,pink
1076,10004,5081,4923,78.0,3722.0,0,pink
1077,10634,5264,5370,91.0,4508.0,0,pink
1078,27759,14218,13541,129.0,11330.0,0,pink
1079,13285,5860,7425,36.0,6708.0,0,pink
1080,31081,15795,15286,135.0,13308.0,0,pink
1081,45388,22896,22492,172.0,19197.0,0,pink
1082,7100,3731,3369,35.0,2750.0,0,pink
1083,24071,12111,11960,124.0,8970.0,0,pink
1084,65374,31046,34328,166.0,23648.0,0,pink
1085,10741,5437,5304,40.0,3155.0,0,pink
1086,4463,2516,1947,34.0,2112.0,0,pink
1087,14520,7160,7360,45.0,4387.0,0,pink
1088,26917,13644,13273,208.0,15962.0,0,pink
1089,60483,30976,29507,377.0,25110.0,0,pink
1090,12321,6273,6048,51.0,6461.0,0,pink
1091,64145,32628,31517,328.0,22164.0,0,pink
1092,2143,996,1147,22.0,914.0,0,pink
1093,16827,8657,8170,69.0,6645.0,0,pink
1094,24499,12736,11763,79.0,9772.0,0,pink
1095,17760,9072,8688,100.0,8374.0,0,pink
1096,53517,27001,26516,125.0,22887.0,0,pink
1097,46786,24173,22613,193.0,16863.0,0,pink
1098,18063,9137,8926,105.0,7494.0,0,pink
1099,18246,8969,9277,67.0,7142.0,0,pink
1100,25500,12975,12525,144.0,11884.0,0,pink
1101,12350,6301,6049,48.0,3664.0,0,pink
1102,14344,7267,7077,51.0,5122.0,0,pink
1103,8637,4399,4238,48.0,2760.0,0,pink
1104,14802,7205,7597,63.0,5441.0,0,pink
1105,126427,64554,61873,427.0,55011.0,0,pink
1106,12019,6154,5865,71.0,5080.0,0,pink
1107,20609,10455,10154,106.0,8338.0,0,pink
1108,13155,6698,6457,52.0,4906.0,0,pink
1109,36089,18421,17668,234.0,18441.0,0,pink
1110,7223,3627,3596,30.0,3572.0,0,pink
1111,26097,13533,12564,62.0,9538.0,0,pink
1112,62568,32077,30491,315.0,19034.0,0,pink
1113,25661,11023,14638,147.0,9156.0,0,pink
1114,121176,61178,59998,321.0,45053.0,0,pink
1115,22714,11709,11005,80.0,6866.0,0,pink
1116,40882,20275,20607,223.0,14371.0,0,pink
1117,36769,18057,18712,150.0,11265.0,0,pink
1118,13668,7145,6523,119.0,5160.0,0,pink
1119,126131,63782,62349,555.0,50838.0,0,pink
1120,248361,130533,117828,1290.0,88390.0,0,pink
1121,200182,102579,97603,747.0,67922.0,0,pink
1122,9996,4719,5277,57.0,4675.0,0,pink
1123,6868,3511,3357,12.0,1554.0,0,pink
1124,9893,4679,5214,63.0,3237.0,0,pink
1125,16153,6948,9205,85.0,4281.0,0,pink
1126,20021,9811,10210,93.0,6505.0,0,pink
1127,27216,14044,13172,148.0,9803.0,0,pink
1128,444094,231316,212778,1435.0,143712.0,1,purple
1129,7225,2852,4373,38.0,3399.0,0,pink
1130,19499,8784,10715,183.0,8502.0,0,pink
1131,33636,16494,17142,166.0,10386.0,0,pink
1132,20322,10341,9981,198.0,8934.0,0,pink
1133,22348,9690,12658,100.0,7610.0,0,pink
1134,72691,37183,35508,281.0,23912.0,0,pink
1135,32956,16295,16661,162.0,11749.0,0,pink
1136,15926,7846,8080,87.0,5689.0,0,pink
1137,435300,224125,211175,1474.0,142048.0,1,purple
1138,31467,15877,15590,179.0,8303.0,0,pink
1139,14949,7219,7730,74.0,5161.0,0,pink
1140,240091,122922,117169,551.0,78978.0,0,pink
1141,98214,49953,48261,419.0,34747.0,0,pink
1142,47356,24315,23041,168.0,15476.0,0,pink
1143,138111,70275,67836,494.0,47090.0,0,pink
1144,11472,5764,5708,66.0,3991.0,0,pink
1145,25992,13548,12444,145.0,8528.0,0,pink
1146,38963,20341,18622,193.0,13089.0,0,pink
1147,389648,204271,185377,1221.0,113846.0,0,pink
1148,156075,81222,74853,868.0,64683.0,0,pink
1149,23373,11756,11617,57.0,7984.0,0,pink
1150,22158,11544,10614,101.0,8026.0,0,pink
1151,131546,67865,63681,614.0,42501.0,0,pink
1152,8618,4551,4067,60.0,2673.0,0,pink
1153,20474,10522,9952,110.0,9043.0,0,pink
1154,24088,12159,11929,129.0,8101.0,0,pink
1155,45694,23292,22402,129.0,14419.0,0,pink
1156,52724,26603,26121,165.0,17256.0,0,pink
1157,10411,5372,5039,28.0,2447.0,0,pink
1158,21357,11091,10266,83.0,7403.0,0,pink
1159,43446,22138,21308,199.0,13264.0,0,pink
1160,83449,43298,40151,440.0,27870.0,0,pink
1161,53752,27300,26452,211.0,15953.0,0,pink
1162,51734,26127,25607,286.0,15284.0,0,pink
1163,252093,129746,122347,946.0,91204.0,0,pink
1164,130504,67267,63237,680.0,45106.0,0,pink
1165,4666,2370,2296,13.0,1387.0,0,pink
1166,112587,57282,55305,460.0,38870.0,0,pink
1167,22475,11343,11132,146.0,8931.0,0,pink
1168,59867,30746,29121,247.0,19109.0,0,pink
1169,51007,23881,27126,203.0,11804.0,0,pink
1170,46457,23494,22963,277.0,16225.0,0,pink
1171,39631,20389,19242,210.0,14552.0,0,pink
1172,25860,12997,12863,97.0,9639.0,0,pink
1173,11180,5476,5704,77.0,4922.0,0,pink
1174,15377,5575,9802,53.0,3859.0,0,pink
1175,14494,6761,7733,75.0,5604.0,0,pink
1176,107444,54930,52514,336.0,28242.0,0,pink
1177,68269,34524,33745,199.0,18185.0,0,pink
1178,290944,149668,141276,503.0,65859.0,0,pink
1179,30019,15368,14651,71.0,7256.0,0,pink
1180,54541,28167,26374,119.0,10117.0,0,pink
1181,121545,62386,59159,311.0,29979.0,0,pink
1182,39823,20122,19701,55.0,8092.0,0,pink
1183,34067,17443,16624,47.0,6865.0,0,pink
1184,57325,29009,28316,179.0,14471.0,0,pink
1185,151748,76552,75196,391.0,37170.0,0,pink
1186,16887,8447,8440,45.0,3917.0,0,pink
1187,35277,18049,17228,46.0,7003.0,0,pink
1188,50710,25625,25085,127.0,12871.0,0,pink
1189,39418,20071,19347,79.0,8021.0,0,pink
1190,31694,16080,15614,73.0,5722.0,0,pink
1191,203102,104073,99029,363.0,51649.0,0,pink
1192,71977,34331,37646,390.0,21650.0,0,pink
1193,567696,286520,281176,1281.0,119223.0,1,purple
1194,827625,435204,392421,2817.0,171679.0,1,purple
1195,614700,326009,288691,1971.0,149095.0,1,purple
1196,91082,45775,45307,171.0,14745.0,0,pink
1197,32875,16854,16021,92.0,7316.0,0,pink
1198,167522,84681,82841,489.0,28021.0,0,pink
1199,102517,51368,51149,288.0,20277.0,0,pink
1200,157671,81600,76071,413.0,38601.0,0,pink
1201,32261,16926,15335,116.0,9532.0,0,pink
1202,248472,125948,122524,619.0,58240.0,0,pink
1203,29376,14815,14561,128.0,7165.0,0,pink
1204,251025,128262,122763,678.0,49872.0,0,pink
1205,315327,161042,154285,472.0,63923.0,0,pink
1206,19593,10249,9344,85.0,3980.0,0,pink
1207,1040133,537744,502389,2366.0,244921.0,1,purple
1208,906202,469756,436446,2387.0,228545.0,1,purple
1209,49355,24929,24426,132.0,8823.0,0,pink
1210,25737,11904,13833,85.0,6189.0,0,pink
1211,111531,55979,55552,260.0,24539.0,0,pink
1212,37211,19585,17626,115.0,7221.0,0,pink
1213,149811,73713,76098,645.0,40900.0,0,pink
1214,102172,53637,48535,366.0,24790.0,0,pink
1215,51564,26281,25283,195.0,10871.0,0,pink
1216,213690,111514,102176,776.0,49264.0,0,pink
1217,127328,65725,61603,480.0,35120.0,0,pink
1218,558905,288281,270624,2564.0,181619.0,1,purple
1219,17313,8838,8475,0.0,0.0,0,pink
1220,781024,404549,376475,3301.0,255988.0,1,purple
1221,70935,36334,34601,204.0,14678.0,0,pink
1222,469116,242561,226555,2173.0,171217.0,1,purple
1223,161159,85733,75426,462.0,39530.0,0,pink
1224,1595192,815526,779666,4863.0,435289.0,1,purple
1225,11101,5451,5650,0.0,0.0,0,pink
1226,698249,362911,335338,2367.0,172873.0,1,purple
1227,512135,263009,249126,1995.0,142931.0,1,purple
1228,791766,408936,382830,2296.0,267163.0,1,purple
1229,822280,416846,405434,3087.0,239497.0,1,purple
1230,10364,5140,5224,79.0,1943.0,0,pink
1231,9194,4090,5104,21.0,2133.0,0,pink
1232,115250,57664,57586,408.0,32111.0,0,pink
1233,28612,14517,14095,163.0,6544.0,0,pink
1234,23177,11662,11515,81.0,5275.0,0,pink
1235,15165,7484,7681,90.0,3900.0,0,pink
1236,8507,3787,4720,65.0,2654.0,0,pink
1237,60057,29809,30248,197.0,16954.0,0,pink
1238,104786,53300,51486,698.0,31647.0,0,pink
1239,17552,8809,8743,79.0,4161.0,0,pink
1240,154807,79070,75737,704.0,41943.0,0,pink
1241,43584,21099,22485,214.0,13463.0,0,pink
1242,134473,68691,65782,696.0,42396.0,0,pink
1243,51460,25671,25789,175.0,13096.0,0,pink
1244,26219,13312,12907,71.0,5876.0,0,pink
1245,25458,12738,12720,134.0,5787.0,0,pink
1246,37834,17040,20794,126.0,10338.0,0,pink
1247,30616,15457,15159,185.0,8130.0,0,pink
1248,77896,39368,38528,246.0,28088.0,0,pink
1249,13836,6776,7060,39.0,3216.0,0,pink
1250,36190,18192,17998,194.0,12421.0,0,pink
1251,25570,12816,12754,133.0,9346.0,0,pink
1252,109155,55802,53353,485.0,34893.0,0,pink
1253,33039,16732,16307,109.0,7619.0,0,pink
1254,409361,211979,197382,2035.0,124802.0,1,purple
1255,25289,12550,12739,140.0,6785.0,0,pink
1256,15414,7090,8324,83.0,4291.0,0,pink
1257,91746,46379,45367,281.0,21525.0,0,pink
1258,41067,19106,21961,213.0,13624.0,0,pink
1259,45830,23032,22798,232.0,12754.0,0,pink
1260,36360,16692,19668,115.0,9500.0,0,pink
1261,31543,15851,15692,173.0,9758.0,0,pink
1262,289564,148594,140970,924.0,84381.0,0,pink
1263,64176,30123,34053,209.0,20061.0,0,pink
1264,25247,12669,12578,177.0,5693.0,0,pink
1265,11212,5617,5595,103.0,3600.0,0,pink
1266,70775,36404,34371,238.0,17959.0,0,pink
1267,158913,77708,81205,648.0,50275.0,0,pink
1268,261573,133548,128025,828.0,75496.0,0,pink
1269,17463,8555,8908,73.0,4498.0,0,pink
1270,643140,326406,316734,1887.0,201309.0,1,purple
1271,2130,1019,1111,17.0,697.0,0,pink
1272,11763,5763,6000,43.0,2454.0,0,pink
1273,88202,43360,44842,485.0,24266.0,0,pink
1274,21639,10897,10742,69.0,4442.0,0,pink
1275,98474,48659,49815,376.0,30805.0,0,pink
1276,188482,93916,94566,556.0,58086.0,0,pink
1277,6364,2621,3743,23.0,1781.0,0,pink
1278,10817,5354,5463,42.0,3000.0,0,pink
1279,868704,445869,422835,4602.0,299251.0,1,purple
1280,24444,11786,12658,118.0,4904.0,0,pink
1281,66939,33236,33703,172.0,19339.0,0,pink
1282,28884,14574,14310,120.0,8342.0,0,pink
1283,43264,21420,21844,133.0,10285.0,0,pink
1284,23234,11453,11781,92.0,7146.0,0,pink
1285,83389,42409,40980,271.0,23434.0,0,pink
1286,15006,7338,7668,73.0,3584.0,0,pink
1287,149699,75785,73914,555.0,48204.0,0,pink
1288,63209,30614,32595,252.0,18067.0,0,pink
1289,9261,4596,4665,57.0,2021.0,0,pink
1290,173043,86960,86083,737.0,48775.0,0,pink
1291,48142,23993,24149,189.0,13686.0,0,pink
1292,1250843,640072,610771,4560.0,383297.0,1,purple
1293,26417,13005,13412,106.0,7718.0,0,pink
1294,20928,10448,10480,124.0,5087.0,0,pink
1295,5968,2914,3054,46.0,1348.0,0,pink
1296,23232,11494,11738,99.0,5989.0,0,pink
1297,8277,4026,4251,64.0,1709.0,0,pink
1298,24397,12336,12061,122.0,6783.0,0,pink
1299,284034,143749,140285,947.0,87709.0,0,pink
1300,12797,6411,6386,70.0,2398.0,0,pink
1301,23877,12020,11857,133.0,5615.0,0,pink
1302,192778,99197,93581,1091.0,60992.0,0,pink
1303,41376,20842,20534,231.0,10606.0,0,pink
1304,8069,4085,3984,20.0,2246.0,0,pink
1305,68493,34692,33801,272.0,22166.0,0,pink
1306,159566,80266,79300,950.0,50424.0,0,pink
1307,60897,30638,30259,245.0,16075.0,0,pink
1308,53250,26518,26732,322.0,15754.0,0,pink
1309,75272,37843,37429,342.0,20756.0,0,pink
1310,365961,184585,181376,667.0,109153.0,0,pink
1311,1761382,913734,847648,9100.0,533721.0,1,purple
1312,33111,16544,16567,132.0,8666.0,0,pink
1313,15834,7781,8053,65.0,3709.0,0,pink
1314,347431,173620,173811,885.0,118685.0,0,pink
1315,33773,16990,16783,102.0,10459.0,0,pink
1316,46117,23211,22906,141.0,14297.0,0,pink
1317,39779,19885,19894,199.0,16968.0,0,pink
1318,5016,2539,2477,11.0,1762.0,0,pink
1319,66322,32999,33323,122.0,21250.0,0,pink
1320,25211,12558,12653,90.0,7928.0,0,pink
1321,35540,16975,18565,122.0,11564.0,0,pink
1322,100416,50623,49793,146.0,31925.0,0,pink
1323,29022,14224,14798,96.0,8592.0,0,pink
1324,12010,6051,5959,55.0,3809.0,0,pink
1325,54727,26394,28333,135.0,17200.0,0,pink
1326,62801,31791,31010,140.0,23643.0,0,pink
1327,8812,4308,4504,32.0,2527.0,0,pink
1328,5311,2679,2632,6.0,840.0,0,pink
1329,11372,5710,5662,42.0,3774.0,0,pink
1330,63855,31889,31966,189.0,19276.0,0,pink
1331,418201,212292,205909,908.0,136300.0,1,purple
1332,20582,10248,10334,25.0,6699.0,0,pink
1333,37203,18596,18607,140.0,13309.0,0,pink
1334,13896,6947,6949,62.0,4475.0,0,pink
1335,20888,10397,10491,36.0,5832.0,0,pink
1336,30526,15309,15217,91.0,10540.0,0,pink
1337,46217,23124,23093,154.0,15543.0,0,pink
1338,5938,2918,3020,16.0,1829.0,0,pink
1339,1235478,624948,610530,2931.0,383507.0,1,purple
1340,18663,9314,9349,26.0,5475.0,0,pink
1341,20862,10312,10550,69.0,6090.0,0,pink
1342,38974,19254,19720,133.0,11686.0,0,pink
1343,45203,22290,22913,174.0,13535.0,0,pink
1344,10047,4978,5069,22.0,2654.0,0,pink
1345,16004,7871,8133,62.0,4333.0,0,pink
1346,42658,21228,21430,150.0,15832.0,0,pink
1347,4337,2138,2199,32.0,1253.0,0,pink
1348,12644,6317,6327,43.0,3696.0,0,pink
1349,6773,3396,3377,31.0,2192.0,0,pink
1350,10569,5141,5428,35.0,2655.0,0,pink
1351,3809,1772,2037,7.0,928.0,0,pink
1352,27983,13877,14106,56.0,7512.0,0,pink
1353,5707,2852,2855,7.0,1517.0,0,pink
1354,25839,13051,12788,82.0,8249.0,0,pink
1355,5506,2778,2728,19.0,2181.0,0,pink
1356,9392,4631,4761,25.0,2512.0,0,pink
1357,19964,9896,10068,75.0,6650.0,0,pink
1358,35825,17903,17922,123.0,12989.0,0,pink
1359,23079,11352,11727,82.0,7138.0,0,pink
1360,25728,12862,12866,137.0,8368.0,0,pink
1361,32949,16310,16639,121.0,11106.0,0,pink
1362,39602,19557,20045,83.0,13814.0,0,pink
1363,8353,4183,4170,22.0,2395.0,0,pink
1364,33783,16846,16937,75.0,9839.0,0,pink
1365,21839,10603,11236,65.0,8119.0,0,pink
1366,6559,3235,3324,17.0,1799.0,0,pink
1367,153065,78229,74836,228.0,52776.0,0,pink
1368,57992,28729,29263,189.0,16259.0,0,pink
1369,14184,7130,7054,44.0,4309.0,0,pink
1370,29129,13481,15648,75.0,8540.0,0,pink
1371,9185,4744,4441,37.0,2371.0,0,pink
1372,31591,15624,15967,128.0,10619.0,0,pink
1373,10980,5418,5562,24.0,3958.0,0,pink
1374,541493,277650,263843,1537.0,158471.0,1,purple
1375,4008,1974,2034,14.0,1103.0,0,pink
1376,15331,7612,7719,58.0,4714.0,0,pink
1377,14721,7226,7495,59.0,4523.0,0,pink
1378,65765,32185,33580,206.0,20659.0,0,pink
1379,9413,4788,4625,35.0,2783.0,0,pink
1380,15462,7459,8003,48.0,5059.0,0,pink
1381,143372,71966,71406,295.0,47753.0,0,pink
1382,93231,45558,47673,200.0,31932.0,0,pink
1383,14912,7342,7570,29.0,4261.0,0,pink
1384,200080,99593,100487,615.0,60259.0,0,pink
1385,156819,77888,78931,422.0,61290.0,0,pink
1386,36676,18505,18171,76.0,12001.0,0,pink
1387,9784,4874,4910,18.0,3425.0,0,pink
1388,9411,4685,4726,34.0,2732.0,0,pink
1389,24440,11877,12563,73.0,8425.0,0,pink
1390,3337,1693,1644,11.0,1022.0,0,pink
1391,21500,10721,10779,20.0,6658.0,0,pink
1392,13646,6919,6727,67.0,5205.0,0,pink
1393,18809,9809,9000,46.0,6370.0,0,pink
1394,253317,127985,125332,568.0,82238.0,0,pink
1395,10973,5565,5408,26.0,3452.0,0,pink
1396,6343,3128,3215,25.0,1946.0,0,pink
1397,50847,25656,25191,83.0,15816.0,0,pink
1398,132745,65832,66913,346.0,42630.0,0,pink
1399,9868,4812,5056,31.0,3125.0,0,pink
1400,31547,15330,16217,154.0,8553.0,0,pink
1401,37180,18893,18287,174.0,12765.0,0,pink
1402,12468,6461,6007,73.0,3892.0,0,pink
1403,18581,9755,8826,125.0,6762.0,0,pink
1404,8253,4131,4122,51.0,2838.0,0,pink
1405,32592,17227,15365,195.0,11614.0,0,pink
1406,14571,7580,6991,80.0,5581.0,0,pink
1407,10129,5013,5116,58.0,3083.0,0,pink
1408,17279,8948,8331,105.0,6994.0,0,pink
1409,8321,4147,4174,37.0,2903.0,0,pink
1410,9120,4808,4312,51.0,2566.0,0,pink
1411,15928,8485,7443,116.0,4883.0,0,pink
1412,19808,10631,9177,105.0,6199.0,0,pink
1413,23802,12796,11006,139.0,8137.0,0,pink
1414,28721,15017,13704,131.0,9183.0,0,pink
1415,19091,9839,9252,124.0,8662.0,0,pink
1416,176132,90958,85174,584.0,61282.0,0,pink
1417,75517,39573,35944,334.0,27389.0,0,pink
1418,7757,4051,3706,41.0,2374.0,0,pink
1419,23710,11702,12008,92.0,8750.0,0,pink
1420,13714,5420,8294,61.0,3892.0,0,pink
1421,21278,11175,10103,143.0,6392.0,0,pink
1422,46653,23874,22779,164.0,14901.0,0,pink
1423,202626,102876,99750,713.0,65717.0,0,pink
1424,241774,128897,112877,858.0,67444.0,0,pink
1425,18075,9440,8635,108.0,5240.0,0,pink
1426,8539,4549,3990,48.0,2369.0,0,pink
1427,1328,521,807,9.0,309.0,0,pink
1428,23480,11659,11821,151.0,9416.0,0,pink
1429,142014,71949,70065,500.0,45665.0,0,pink
1430,16529,8481,8048,88.0,6163.0,0,pink
1431,7346,3704,3642,41.0,1811.0,0,pink
1432,11495,5952,5543,57.0,3654.0,0,pink
1433,68454,35102,33352,316.0,26379.0,0,pink
1434,10107,4937,5170,53.0,2626.0,0,pink
1435,53459,27485,25974,189.0,18841.0,0,pink
1436,61223,31980,29243,171.0,21870.0,0,pink
1437,77323,39706,37617,387.0,22051.0,0,pink
1438,12630,6500,6130,59.0,4579.0,0,pink
1439,22870,11337,11533,128.0,7637.0,0,pink
1440,84915,44389,40526,331.0,33815.0,0,pink
1441,29804,15888,13916,185.0,8620.0,0,pink
1442,34432,18177,16255,166.0,10457.0,0,pink
1443,59437,31072,28365,255.0,21219.0,0,pink
1444,103498,53974,49524,350.0,31530.0,0,pink
1445,25202,12972,12230,149.0,8759.0,0,pink
1446,35787,18051,17736,189.0,12008.0,0,pink
1447,35840,18733,17107,232.0,13691.0,0,pink
1448,10198,5429,4769,84.0,3684.0,0,pink
1449,29376,15388,13988,249.0,12823.0,0,pink
1450,21524,11382,10142,106.0,7126.0,0,pink
1451,10828,5701,5127,52.0,3623.0,0,pink
1452,49481,24618,24863,175.0,13700.0,0,pink
1453,34243,17694,16549,180.0,12409.0,0,pink
1454,55149,27886,27263,290.0,17771.0,0,pink
1455,12028,6183,5845,66.0,3754.0,0,pink
1456,39737,20901,18836,197.0,12740.0,0,pink
1457,31315,16011,15304,158.0,12792.0,0,pink
1458,25360,13056,12304,115.0,10216.0,0,pink
1459,7372,3896,3476,35.0,1848.0,0,pink
1460,151240,78199,73041,528.0,46672.0,0,pink
1461,28415,14545,13870,123.0,7857.0,0,pink
1462,4511,2364,2147,29.0,1184.0,0,pink
1463,27073,13958,13115,161.0,8614.0,0,pink
1464,16063,8216,7847,72.0,5060.0,0,pink
1465,18375,9008,9367,83.0,6716.0,0,pink
1466,26532,12605,13927,133.0,7053.0,0,pink
1467,14361,6349,8012,68.0,3961.0,0,pink
1468,28493,14665,13828,159.0,8704.0,0,pink
1469,21990,11317,10673,117.0,8916.0,0,pink
1470,19478,9987,9491,123.0,7685.0,0,pink
1471,10170,5511,4659,51.0,3055.0,0,pink
1472,28356,14414,13942,135.0,11594.0,0,pink
1473,14601,7493,7108,84.0,4671.0,0,pink
1474,47075,24647,22428,222.0,12709.0,0,pink
1475,47086,25068,22018,213.0,12919.0,0,pink
1476,20422,10350,10072,92.0,6958.0,0,pink
1477,9828,5040,4788,76.0,4064.0,0,pink
1478,8990,4174,4816,47.0,1954.0,0,pink
1479,18358,9416,8942,104.0,6722.0,0,pink
1480,12421,6336,6085,64.0,4859.0,0,pink
1481,27974,12431,15543,116.0,9990.0,0,pink
1482,25325,13110,12215,72.0,6811.0,0,pink
1483,17403,8683,8720,67.0,5734.0,0,pink
1484,5270,2655,2615,24.0,1844.0,0,pink
1485,25735,13967,11768,132.0,7019.0,0,pink
1486,35493,17670,17823,155.0,8014.0,0,pink
1487,11850,5985,5865,59.0,3401.0,0,pink
1488,16374,8360,8014,104.0,4506.0,0,pink
1489,18989,9635,9354,122.0,5518.0,0,pink
1490,12281,6141,6140,55.0,3301.0,0,pink
1491,176515,90688,85827,309.0,53414.0,0,pink
1492,89076,44385,44691,357.0,29872.0,0,pink
1493,42733,21910,20823,187.0,12510.0,0,pink
1494,9049,4464,4585,43.0,2137.0,0,pink
1495,44840,21966,22874,149.0,14444.0,0,pink
1496,45096,22768,22328,199.0,10911.0,0,pink
1497,78324,40392,37932,289.0,23710.0,0,pink
1498,8843,4513,4330,48.0,2746.0,0,pink
1499,6197,3187,3010,24.0,1777.0,0,pink
1500,102678,52314,50364,360.0,30434.0,0,pink
1501,13938,6977,6961,63.0,3776.0,0,pink
1502,7546,3782,3764,44.0,2024.0,0,pink
1503,84275,43280,40995,297.0,25079.0,0,pink
1504,6800,3353,3447,49.0,1946.0,0,pink
1505,239164,121868,117296,459.0,33863.0,0,pink
1506,20475,10209,10266,134.0,5906.0,0,pink
1507,76740,38009,38731,317.0,24096.0,0,pink
1508,17622,8408,9214,84.0,4833.0,0,pink
1509,24280,12311,11969,119.0,6621.0,0,pink
1510,7590,3706,3884,49.0,1839.0,0,pink
1511,16499,8287,8212,83.0,4740.0,0,pink
1512,8302,4115,4187,33.0,2091.0,0,pink
1513,12564,4617,7947,52.0,2601.0,0,pink
1514,15504,7812,7692,93.0,3991.0,0,pink
1515,13374,6674,6700,87.0,3085.0,0,pink
1516,30428,15805,14623,139.0,9796.0,0,pink
1517,102781,51442,51339,419.0,31511.0,0,pink
1518,14746,7373,7373,117.0,4200.0,0,pink
1519,6665,3447,3218,39.0,2731.0,0,pink
1520,288429,148063,140366,1170.0,85022.0,0,pink
1521,10039,5133,4906,75.0,3198.0,0,pink
1522,8554,4291,4263,39.0,2539.0,0,pink
1523,21765,11122,10643,96.0,7114.0,0,pink
1524,9368,4817,4551,59.0,2413.0,0,pink
1525,4456,2259,2197,34.0,1326.0,0,pink
1526,10113,5071,5042,38.0,2992.0,0,pink
1527,40102,20462,19640,236.0,11085.0,0,pink
1528,10221,5192,5029,52.0,2797.0,0,pink
1529,692003,357399,334604,1430.0,122383.0,1,purple
1530,119238,61015,58223,810.0,41106.0,0,pink
1531,223302,112415,110887,761.0,68323.0,0,pink
1532,53689,25974,27715,158.0,15126.0,0,pink
1533,3951,1962,1989,16.0,1205.0,0,pink
1534,35507,17929,17578,199.0,9666.0,0,pink
1535,32589,16483,16106,150.0,9369.0,0,pink
1536,38133,19138,18995,194.0,9422.0,0,pink
1537,10027,4927,5100,44.0,3436.0,0,pink
1538,55563,28037,27526,165.0,18655.0,0,pink
1539,12186,6325,5861,83.0,3283.0,0,pink
1540,15076,8263,6813,110.0,4593.0,0,pink
1541,15254,7571,7683,69.0,4347.0,0,pink
1542,12205,6156,6049,60.0,4316.0,0,pink
1543,8884,4435,4449,43.0,1974.0,0,pink
1544,28672,14927,13745,135.0,9877.0,0,pink
1545,22827,11192,11635,81.0,6262.0,0,pink
1546,3664,1830,1834,17.0,920.0,0,pink
1547,25049,12735,12314,133.0,7073.0,0,pink
1548,13748,6173,7575,66.0,4437.0,0,pink
1549,15958,7545,8413,62.0,4406.0,0,pink
1550,8654,4252,4402,51.0,2543.0,0,pink
1551,11545,5781,5764,65.0,3311.0,0,pink
1552,20137,10192,9945,127.0,4929.0,0,pink
1553,17811,9253,8558,98.0,6143.0,0,pink
1554,58202,29238,28964,227.0,13998.0,0,pink
1555,22547,11322,11225,55.0,7477.0,0,pink
1556,10699,5323,5376,41.0,2497.0,0,pink
1557,13619,6543,7076,52.0,3809.0,0,pink
1558,9236,4644,4592,68.0,2084.0,0,pink
1559,17031,9009,8022,90.0,3810.0,0,pink
1560,19146,9689,9457,54.0,6358.0,0,pink
1561,42371,21453,20918,198.0,14977.0,0,pink
1562,44789,21248,23541,266.0,12971.0,0,pink
1563,18489,8272,10217,66.0,5280.0,0,pink
1564,98824,50104,48720,110.0,12870.0,0,pink
1565,31549,16114,15435,123.0,10023.0,0,pink
1566,52591,22566,30025,134.0,10849.0,0,pink
1567,4815,2426,2389,27.0,1214.0,0,pink
1568,10217,5039,5178,31.0,2976.0,0,pink
1569,24945,11843,13102,115.0,7294.0,0,pink
1570,22825,11468,11357,110.0,6253.0,0,pink
1571,6315,3077,3238,27.0,1414.0,0,pink
1572,13693,6876,6817,71.0,3262.0,0,pink
1573,23102,11543,11559,119.0,7337.0,0,pink
1574,4502,2283,2219,27.0,899.0,0,pink
1575,4898,2499,2399,20.0,888.0,0,pink
1576,38729,20017,18712,176.0,13915.0,0,pink
1577,8246,4234,4012,43.0,1939.0,0,pink
1578,6061,3014,3047,18.0,2115.0,0,pink
1579,389985,198344,191641,1103.0,119873.0,0,pink
1580,9383,4720,4663,45.0,2656.0,0,pink
1581,66342,30442,35900,333.0,23656.0,0,pink
1582,998684,525074,473610,3749.0,296358.0,1,purple
1583,311273,160741,150532,861.0,75924.0,0,pink
1584,17871,8892,8979,41.0,4888.0,0,pink
1585,29512,15147,14365,152.0,7218.0,0,pink
1586,31527,16118,15409,139.0,6983.0,0,pink
1587,6317,3265,3052,32.0,2082.0,0,pink
1588,54720,28216,26504,267.0,16114.0,0,pink
1589,25671,12274,13397,114.0,5693.0,0,pink
1590,20691,10603,10088,119.0,6257.0,0,pink
1591,33908,17194,16714,118.0,9965.0,0,pink
1592,24931,12096,12835,156.0,7147.0,0,pink
1593,13308,6764,6544,58.0,2989.0,0,pink
1594,38082,18646,19436,168.0,10412.0,0,pink
1595,2040,1059,981,5.0,567.0,0,pink
1596,18293,9264,9029,97.0,4617.0,0,pink
1597,9393,4645,4748,33.0,2490.0,0,pink
1598,13376,6804,6572,111.0,5995.0,0,pink
1599,6727,3359,3368,35.0,2596.0,0,pink
1600,5834,2859,2975,23.0,1545.0,0,pink
1601,10546,5229,5317,34.0,2466.0,0,pink
1602,1318,669,649,5.0,321.0,0,pink
1603,81746,40477,41269,380.0,30134.0,0,pink
1604,5789,2950,2839,15.0,1357.0,0,pink
1605,11845,5890,5955,53.0,3524.0,0,pink
1606,1753,869,884,10.0,486.0,0,pink
1607,9191,4314,4877,63.0,2898.0,0,pink
1608,9100,4265,4835,32.0,3244.0,0,pink
1609,2838,1366,1472,13.0,801.0,0,pink
1610,11273,5591,5682,63.0,2968.0,0,pink
1611,98082,49259,48823,306.0,33773.0,0,pink
1612,104729,50483,54246,139.0,41584.0,0,pink
1613,1141,536,605,3.0,268.0,0,pink
1614,13699,6844,6855,79.0,4783.0,0,pink
1615,724,369,355,5.0,176.0,0,pink
1616,3269,1573,1696,10.0,673.0,0,pink
1617,16439,8147,8292,78.0,5398.0,0,pink
1618,11778,5799,5979,27.0,3148.0,0,pink
1619,1951,893,1058,1.0,285.0,0,pink
1620,29774,15030,14744,107.0,8320.0,0,pink
1621,67077,33891,33186,205.0,21813.0,0,pink
1622,2280,1134,1146,4.0,538.0,0,pink
1623,19358,9680,9678,101.0,5615.0,0,pink
1624,8218,3957,4261,25.0,2420.0,0,pink
1625,1630,802,828,9.0,469.0,0,pink
1626,1968,1002,966,12.0,600.0,0,pink
1627,4211,2076,2135,19.0,1369.0,0,pink
1628,115983,57611,58372,234.0,33829.0,0,pink
1629,4807,2408,2399,32.0,1110.0,0,pink
1630,16246,8082,8164,41.0,5136.0,0,pink
1631,432,203,229,1.0,51.0,0,pink
1632,4124,2023,2101,32.0,1149.0,0,pink
1633,6044,3041,3003,13.0,1494.0,0,pink
1634,1619,799,820,10.0,425.0,0,pink
1635,6861,2551,4310,33.0,2234.0,0,pink
1636,1342,669,673,4.0,295.0,0,pink
1637,41902,21080,20822,175.0,8502.0,0,pink
1638,11360,5620,5740,42.0,3011.0,0,pink
1639,11228,5669,5559,80.0,4034.0,0,pink
1640,9250,4642,4608,64.0,3278.0,0,pink
1641,11521,5586,5935,55.0,2436.0,0,pink
1642,3574,1780,1794,13.0,906.0,0,pink
1643,34814,17226,17588,144.0,9955.0,0,pink
1644,9410,4717,4693,33.0,1736.0,0,pink
1645,3653,1883,1770,13.0,920.0,0,pink
1646,6080,3086,2994,29.0,1539.0,0,pink
1647,4976,2152,2824,25.0,1432.0,0,pink
1648,777,393,384,1.0,153.0,0,pink
1649,7532,3802,3730,44.0,2158.0,0,pink
1650,2149,1070,1079,14.0,463.0,0,pink
1651,1175,614,561,9.0,249.0,0,pink
1652,157816,80043,77773,612.0,51038.0,0,pink
1653,31583,15636,15947,92.0,7928.0,0,pink
1654,6372,3168,3204,21.0,1342.0,0,pink
1655,418,213,205,1.0,36.0,0,pink
1656,696,350,346,3.0,116.0,0,pink
1657,480,234,246,4.0,87.0,0,pink
1658,5313,2672,2641,16.0,1352.0,0,pink
1659,11089,5617,5472,30.0,2641.0,0,pink
1660,2042,1014,1028,14.0,501.0,0,pink
1661,2988,1558,1430,8.0,686.0,0,pink
1662,49030,24437,24593,153.0,14326.0,0,pink
1663,6528,3319,3209,25.0,1587.0,0,pink
1664,8067,4011,4056,21.0,2347.0,0,pink
1665,25702,12773,12929,55.0,7343.0,0,pink
1666,8523,4194,4329,31.0,1884.0,0,pink
1667,3734,1869,1865,10.0,915.0,0,pink
1668,5790,2943,2847,14.0,649.0,0,pink
1669,9852,4949,4903,33.0,2483.0,0,pink
1670,6232,3067,3165,34.0,1768.0,0,pink
1671,10760,4890,5870,31.0,3054.0,0,pink
1672,8991,4486,4505,27.0,2076.0,0,pink
1673,10830,5464,5366,42.0,2451.0,0,pink
1674,20317,10098,10219,93.0,8017.0,0,pink
1675,8896,4325,4571,34.0,1576.0,0,pink
1676,23804,11563,12241,95.0,5954.0,0,pink
1677,1894,1002,892,5.0,394.0,0,pink
1678,5746,2862,2884,20.0,1462.0,0,pink
1679,36683,18557,18126,157.0,11975.0,0,pink
1680,554992,281249,273743,1275.0,179808.0,1,purple
1681,2023,1010,1013,6.0,434.0,0,pink
1682,5574,2792,2782,22.0,1350.0,0,pink
1683,3006,1516,1490,15.0,526.0,0,pink
1684,2609,1283,1326,4.0,642.0,0,pink
1685,4786,2437,2349,19.0,1338.0,0,pink
1686,21595,10769,10826,66.0,4603.0,0,pink
1687,1860,923,937,6.0,490.0,0,pink
1688,1975,1006,969,14.0,495.0,0,pink
1689,2015,1015,1000,9.0,461.0,0,pink
1690,718,338,380,7.0,125.0,0,pink
1691,2410,1203,1207,7.0,488.0,0,pink
1692,61343,30513,30830,178.0,19864.0,0,pink
1693,9178,4614,4564,27.0,2837.0,0,pink
1694,3438,1657,1781,8.0,469.0,0,pink
1695,943,448,495,0.0,146.0,0,pink
1696,2843,1429,1414,11.0,781.0,0,pink
1697,10245,5103,5142,26.0,2609.0,0,pink
1698,691,367,324,5.0,134.0,0,pink
1699,6405,3178,3227,32.0,1375.0,0,pink
1700,7188,3702,3486,15.0,1460.0,0,pink
1701,5197,2100,3097,17.0,1010.0,0,pink
1702,6552,3312,3240,14.0,1465.0,0,pink
1703,8099,3958,4141,30.0,1825.0,0,pink
1704,792,376,416,0.0,147.0,0,pink
1705,3667,1812,1855,26.0,871.0,0,pink
1706,8460,4310,4150,21.0,1999.0,0,pink
1707,310094,154395,155699,494.0,94217.0,0,pink
1708,35433,17936,17497,142.0,10815.0,0,pink
1709,886,424,462,0.0,197.0,0,pink
1710,585,294,291,0.0,117.0,0,pink
1711,35164,17674,17490,84.0,11623.0,0,pink
1712,454,213,241,1.0,102.0,0,pink
1713,7803,3884,3919,26.0,2086.0,0,pink
1714,4841,2396,2445,45.0,1494.0,0,pink
1715,3554,1785,1769,18.0,954.0,0,pink
1716,7004,3539,3465,33.0,1823.0,0,pink
1717,4275,2135,2140,19.0,1127.0,0,pink
1718,15896,8154,7742,29.0,3921.0,0,pink
1719,2676,1399,1277,9.0,540.0,0,pink
1720,2907,1408,1499,14.0,606.0,0,pink
1721,9120,4542,4578,26.0,2810.0,0,pink
1722,7157,3591,3566,29.0,1622.0,0,pink
1723,33063,16203,16860,88.0,10474.0,0,pink
1724,5255,2715,2540,26.0,1612.0,0,pink
1725,10806,5405,5401,26.0,2771.0,0,pink
1726,8009,4035,3974,34.0,2344.0,0,pink
1727,1350,676,674,3.0,202.0,0,pink
1728,14288,7031,7257,19.0,4462.0,0,pink
1729,178351,89175,89176,336.0,58797.0,0,pink
1730,21024,10396,10628,56.0,5628.0,0,pink
1731,36255,18680,17575,208.0,11307.0,0,pink
1732,17127,8401,8726,52.0,3865.0,0,pink
1733,5234,2668,2566,53.0,1178.0,0,pink
1734,3042,1515,1527,9.0,728.0,0,pink
1735,1266,623,643,1.0,120.0,0,pink
1736,5992,2990,3002,13.0,931.0,0,pink
1737,5098,2553,2545,13.0,1315.0,0,pink
1738,645,324,321,1.0,126.0,0,pink
1739,7140,3595,3545,38.0,2199.0,0,pink
1740,4224,2151,2073,14.0,922.0,0,pink
1741,20219,10308,9911,54.0,5503.0,0,pink
1742,9367,4651,4716,19.0,2211.0,0,pink
1743,3571,1802,1769,15.0,886.0,0,pink
1744,822,387,435,2.0,156.0,0,pink
1745,13799,7106,6693,34.0,4904.0,0,pink
1746,54467,26555,27912,243.0,17384.0,0,pink
1747,24010,11872,12138,125.0,7670.0,0,pink
1748,2141574,1071795,1069779,9312.0,669469.0,2,dark purple
1749,47828,23726,24102,100.0,10186.0,0,pink
1750,52252,25053,27199,155.0,14381.0,0,pink
1751,981,575,406,6.0,132.0,0,pink
1752,1830,909,921,3.0,398.0,0,pink
1753,16904,8125,8779,68.0,5441.0,0,pink
1754,5746,2399,3347,23.0,1441.0,0,pink
1755,5174,2501,2673,11.0,1286.0,0,pink
1756,53155,26398,26757,186.0,13803.0,0,pink
1757,4448,2243,2205,23.0,1506.0,0,pink
1758,43705,21462,22243,309.0,9434.0,0,pink
1759,6611,2325,4286,34.0,2371.0,0,pink
1760,3941,1978,1963,15.0,473.0,0,pink
1761,450486,223735,226751,1317.0,129511.0,1,purple
1762,9737,4033,5704,29.0,2179.0,0,pink
1763,60640,30904,29736,219.0,17388.0,0,pink
1764,47840,23995,23845,75.0,12259.0,0,pink
1765,76263,39042,37221,134.0,18988.0,0,pink
1766,32038,15164,16874,135.0,8316.0,0,pink
1767,89811,45650,44161,104.0,23221.0,0,pink
1768,411087,206794,204293,1060.0,121180.0,1,purple
1769,149452,75914,73538,308.0,40108.0,0,pink
1770,305129,153928,151201,654.0,84173.0,0,pink
1771,128237,65534,62703,252.0,36911.0,0,pink
1772,43125,21714,21411,84.0,11849.0,0,pink
1773,268539,138513,130026,1115.0,91478.0,0,pink
1774,929999,479215,450784,3801.0,325325.0,1,purple
1775,446367,226833,219534,1403.0,141605.0,1,purple
1776,507367,262299,245068,2017.0,168876.0,1,purple
1777,93705,47876,45829,347.0,30495.0,0,pink
1778,153400,74713,78687,689.0,52783.0,0,pink
1779,793555,411979,381576,3834.0,294005.0,1,purple
1780,290852,149623,141229,1078.0,91300.0,0,pink
1781,668631,336363,332268,2967.0,240456.0,1,purple
1782,125051,62604,62447,314.0,34583.0,0,pink
1783,368762,188393,180369,1383.0,111334.0,0,pink
1784,826698,419451,407247,3189.0,276365.0,1,purple
1785,623387,320233,303154,2426.0,223404.0,1,purple
1786,494383,251899,242484,1798.0,165686.0,1,purple
1787,591939,306568,285371,3465.0,215262.0,1,purple
1788,504041,258578,245463,2602.0,193267.0,1,purple
1789,63336,32354,30982,332.0,18519.0,0,pink
1790,330176,168880,161296,1188.0,98028.0,0,pink
1791,142298,71568,70730,598.0,45673.0,0,pink
1792,553066,283616,269450,2627.0,196832.0,1,purple
1793,106293,54357,51936,609.0,34604.0,0,pink
1794,677692,345421,332271,2248.0,196442.0,1,purple
1795,3539,1609,1930,23.0,540.0,0,pink
1796,65459,32859,32600,368.0,24707.0,0,pink
1797,26978,13330,13648,222.0,9336.0,0,pink
1798,12353,6044,6309,76.0,2816.0,0,pink
1799,50199,24090,26109,240.0,15331.0,0,pink
1800,2060,1008,1052,7.0,769.0,0,pink
1801,215338,109564,105774,964.0,76812.0,0,pink
1802,57437,28448,28989,332.0,19256.0,0,pink
1803,28061,14192,13869,118.0,9844.0,0,pink
1804,4382,1875,2507,20.0,1400.0,0,pink
1805,459,193,266,5.0,106.0,0,pink
1806,4371,2222,2149,17.0,1342.0,0,pink
1807,70126,33989,36137,438.0,22935.0,0,pink
1808,19482,10254,9228,77.0,6589.0,0,pink
1809,18356,9003,9353,25.0,4589.0,0,pink
1810,24264,12244,12020,158.0,8026.0,0,pink
1811,72849,37691,35158,665.0,33053.0,0,pink
1812,4563,2333,2230,22.0,986.0,0,pink
1813,65745,31859,33886,232.0,17113.0,0,pink
1814,8373,4492,3881,72.0,2564.0,0,pink
1815,39307,20057,19250,168.0,13352.0,0,pink
1816,19117,9594,9523,113.0,6218.0,0,pink
1817,127455,64332,63123,870.0,52288.0,0,pink
1818,28034,13926,14108,84.0,7653.0,0,pink
1819,140769,71814,68955,521.0,44846.0,0,pink
1820,148917,76573,72344,400.0,40132.0,0,pink
1821,11135,5619,5516,89.0,2510.0,0,pink
1822,17000,8201,8799,107.0,4743.0,0,pink
1823,32888,16812,16076,108.0,7285.0,0,pink
1824,15595,7237,8358,61.0,3362.0,0,pink
1825,4175,1873,2302,21.0,948.0,0,pink
1826,75956,37826,38130,330.0,23984.0,0,pink
1827,307426,158516,148910,610.0,79033.0,0,pink
1828,47025,23270,23755,166.0,10819.0,0,pink
1829,1437872,760909,676963,8664.0,551497.0,1,purple
1830,194402,98794,95608,598.0,58871.0,0,pink
1831,77686,39195,38491,251.0,19313.0,0,pink
1832,77868,37886,39982,181.0,20541.0,0,pink
1833,129656,65696,63960,345.0,29552.0,0,pink
1834,85740,43184,42556,264.0,26685.0,0,pink
1835,48348,24121,24227,141.0,11847.0,0,pink
1836,80794,39295,41499,132.0,22713.0,0,pink
1837,60919,30424,30495,172.0,13962.0,0,pink
1838,48123,24573,23550,135.0,13445.0,0,pink
1839,45502,22559,22943,94.0,10218.0,0,pink
1840,293894,147720,146174,738.0,85148.0,0,pink
1841,919866,474868,444998,2903.0,269977.0,1,purple
1842,37751,18129,19622,80.0,7741.0,0,pink
1843,50692,22876,27816,57.0,12124.0,0,pink
1844,53743,26896,26847,186.0,16644.0,0,pink
1845,58112,29090,29022,208.0,16636.0,0,pink
1846,47617,22714,24903,153.0,11071.0,0,pink
1847,4575,2228,2347,5.0,1100.0,0,pink
1848,62505,31587,30918,212.0,17543.0,0,pink
1849,114448,54517,59931,160.0,27310.0,0,pink
1850,2600747,1368835,1231912,14285.0,960777.0,2,dark purple
1851,26719,13268,13451,58.0,7375.0,0,pink
1852,63907,31857,32050,140.0,14429.0,0,pink
1853,71359,36107,35252,145.0,16903.0,0,pink
1854,744248,384874,359374,1849.0,192659.0,1,purple
1855,49426,25161,24265,237.0,15093.0,0,pink
1856,1356564,697159,659405,4352.0,549547.0,1,purple
1857,1632480,860336,772144,6245.0,594091.0,1,purple
1858,211704,108577,103127,634.0,59788.0,0,pink
1859,230782,115693,115089,874.0,69358.0,0,pink
1860,464242,240247,223995,1196.0,143106.0,1,purple
1861,109472,55768,53704,220.0,26263.0,0,pink
1862,378227,188743,189484,1265.0,146651.0,0,pink
1863,41175,20636,20539,130.0,10608.0,0,pink
1864,119104,59456,59648,237.0,34783.0,0,pink
1865,60244,31117,29127,110.0,13365.0,0,pink
1866,99070,49774,49296,146.0,31918.0,0,pink
1867,2298513,1183859,1114654,13480.0,902027.0,2,dark purple
1868,159431,80820,78611,313.0,41929.0,0,pink
1869,474101,244677,229424,2730.0,226763.0,1,purple
1870,323686,165019,158667,1004.0,118921.0,0,pink
1871,227377,114909,112468,414.0,61744.0,0,pink
1872,154883,79430,75453,375.0,43916.0,0,pink
1873,31364,15744,15620,44.0,6611.0,0,pink
1874,17992,9013,8979,32.0,4338.0,0,pink
1875,34612,16516,18096,95.0,7693.0,0,pink
1876,109558,53778,55780,221.0,26379.0,0,pink
1877,96927,48530,48397,277.0,25411.0,0,pink
1878,1487901,755632,732269,4952.0,568328.0,1,purple
1879,75211,36616,38595,161.0,24745.0,0,pink
1880,49045,24781,24264,93.0,14110.0,0,pink
1881,102962,52139,50823,101.0,26691.0,0,pink
1882,179303,90529,88774,419.0,43431.0,0,pink
1883,64480,32782,31698,162.0,18993.0,0,pink
1884,61828,29826,32002,137.0,15917.0,0,pink
1885,90856,45885,44971,203.0,21964.0,0,pink
1886,968815,499917,468898,2994.0,335744.0,1,purple
1887,40565,18831,21734,95.0,9954.0,0,pink
1888,25009,13010,11999,43.0,4455.0,0,pink
1889,160576,84317,76259,571.0,61634.0,0,pink
1890,37119,18177,18942,161.0,12904.0,0,pink
1891,10973,5587,5386,21.0,3786.0,0,pink
1892,25306,12021,13285,116.0,8455.0,0,pink
1893,26786,13618,13168,95.0,7818.0,0,pink
1894,17501,8013,9488,50.0,5595.0,0,pink
1895,47243,24534,22709,189.0,16091.0,0,pink
1896,19644,9749,9895,79.0,5481.0,0,pink
1897,33778,17724,16054,149.0,12109.0,0,pink
1898,126860,65579,61281,382.0,40994.0,0,pink
1899,254474,132177,122297,724.0,70784.0,0,pink
1900,89712,44914,44798,382.0,31957.0,0,pink
1901,201448,103354,98094,575.0,72043.0,0,pink
1902,81779,41425,40354,367.0,30365.0,0,pink
1903,10447,5184,5263,10.0,2324.0,0,pink
1904,68920,35081,33839,175.0,18516.0,0,pink
1905,22746,11353,11393,62.0,6638.0,0,pink
1906,156729,80026,76703,685.0,60477.0,0,pink
1907,69791,36314,33477,134.0,18117.0,0,pink
1908,27668,14085,13583,138.0,8813.0,0,pink
1909,14205,7552,6653,67.0,5319.0,0,pink
1910,10813,5688,5125,53.0,3513.0,0,pink
1911,97159,50303,46856,455.0,36703.0,0,pink
1912,56293,28312,27981,296.0,19222.0,0,pink
1913,103082,50836,52246,267.0,32215.0,0,pink
1914,332106,166954,165152,745.0,115683.0,0,pink
1915,25796,12974,12822,42.0,6305.0,0,pink
1916,35741,18127,17614,35.0,10017.0,0,pink
1917,164664,84156,80508,511.0,56019.0,0,pink
1918,41991,21617,20374,125.0,14833.0,0,pink
1919,59062,30282,28780,270.0,20925.0,0,pink
1920,306457,159922,146535,410.0,102870.0,0,pink
1921,53332,28476,24856,184.0,17555.0,0,pink
1922,371573,195236,176337,970.0,125166.0,0,pink
1923,64902,32621,32281,102.0,26425.0,0,pink
1924,216585,112214,104371,981.0,81690.0,0,pink
1925,11563,5936,5627,23.0,2467.0,0,pink
1926,8557,4347,4210,32.0,3011.0,0,pink
1927,58874,28828,30046,129.0,19691.0,0,pink
1928,21008,9415,11593,89.0,7221.0,0,pink
1929,523582,275563,248019,1457.0,160069.0,1,purple
1930,51737,26778,24959,207.0,18828.0,0,pink
1931,130361,65787,64574,379.0,42678.0,0,pink
1932,60433,31213,29220,268.0,17156.0,0,pink
1933,113625,58901,54724,380.0,33204.0,0,pink
1934,24153,12206,11947,104.0,6377.0,0,pink
1935,53239,26919,26320,142.0,19464.0,0,pink
1936,5393,2561,2832,15.0,1718.0,0,pink
1937,172525,87589,84936,556.0,61658.0,0,pink
1938,42256,21418,20838,111.0,12158.0,0,pink
1939,191172,97307,93865,516.0,75584.0,0,pink
1940,9695,4867,4828,55.0,3061.0,0,pink
1941,60125,30900,29225,180.0,20068.0,0,pink
1942,57227,29836,27391,252.0,20215.0,0,pink
1943,81441,41069,40372,206.0,30312.0,0,pink
1944,34410,17780,16630,146.0,9818.0,0,pink
1945,21405,10903,10502,94.0,6305.0,0,pink
1946,23054,12249,10805,100.0,7614.0,0,pink
1947,45109,22276,22833,200.0,17345.0,0,pink
1948,1054314,547593,506721,1897.0,367050.0,1,purple
1949,15040,7640,7400,47.0,4807.0,0,pink
1950,27338,13792,13546,149.0,9007.0,0,pink
1951,95629,49627,46002,391.0,31615.0,0,pink
1952,94003,48878,45125,376.0,32979.0,0,pink
1953,224231,116957,107274,466.0,64412.0,0,pink
1954,20186,10341,9845,98.0,5930.0,0,pink
1955,193912,86231,107681,435.0,65140.0,0,pink
1956,142938,74751,68187,162.0,39281.0,0,pink
1957,12742,6179,6563,38.0,3492.0,0,pink
1958,39479,20333,19146,138.0,10666.0,0,pink
1959,59020,29781,29239,161.0,18810.0,0,pink
1960,13459,6966,6493,28.0,3571.0,0,pink
1961,39305,20316,18989,119.0,12157.0,0,pink
1962,177372,93752,83620,292.0,66885.0,0,pink
1963,20458,10776,9682,72.0,5054.0,0,pink
1964,142958,72530,70428,514.0,44504.0,0,pink
1965,45189,23065,22124,213.0,16417.0,0,pink
1966,133442,69077,64365,602.0,52060.0,0,pink
1967,91270,47281,43989,334.0,27576.0,0,pink
1968,139605,70440,69165,638.0,51513.0,0,pink
1969,66532,34274,32258,441.0,21688.0,0,pink
1970,63561,32330,31231,214.0,23497.0,0,pink
1971,35262,17864,17398,149.0,12824.0,0,pink
1972,61114,30669,30445,298.0,24071.0,0,pink
1973,45905,23422,22483,210.0,15562.0,0,pink
1974,72099,37241,34858,425.0,28537.0,0,pink
1975,14254,7455,6799,55.0,5125.0,0,pink
1976,33513,17468,16045,93.0,8382.0,0,pink
1977,4119,1754,2365,9.0,1235.0,0,pink
1978,226694,115036,111658,534.0,79198.0,0,pink
1979,44482,23659,20823,139.0,15840.0,0,pink
1980,1046558,537692,508866,1323.0,390718.0,1,purple
1981,20033,10048,9985,55.0,5842.0,0,pink
1982,12156,6430,5726,56.0,3909.0,0,pink
1983,54117,26972,27145,80.0,15873.0,0,pink
1984,124002,63362,60640,462.0,41781.0,0,pink
1985,68460,34741,33719,314.0,23024.0,0,pink
1986,81336,42974,38362,363.0,27672.0,0,pink
1987,37665,18999,18666,147.0,15092.0,0,pink
1988,17667,9019,8648,77.0,6544.0,0,pink
1989,2351,1236,1115,10.0,689.0,0,pink
1990,10836,5406,5430,47.0,3590.0,0,pink
1991,6886,3357,3529,23.0,2286.0,0,pink
1992,946,390,556,1.0,169.0,0,pink
1993,6589,3132,3457,26.0,1873.0,0,pink
1994,3195,1605,1590,9.0,930.0,0,pink
1995,2213,1030,1183,3.0,491.0,0,pink
1996,93737,46585,47152,303.0,40966.0,0,pink
1997,174202,85856,88346,334.0,71025.0,0,pink
1998,3824,1865,1959,7.0,975.0,0,pink
1999,4970,2520,2450,39.0,1786.0,0,pink
2000,2369,1195,1174,4.0,596.0,0,pink
2001,4387,2089,2298,8.0,1195.0,0,pink
2002,2313,1228,1085,6.0,895.0,0,pink
2003,3352,1648,1704,18.0,838.0,0,pink
2004,3290,1674,1616,23.0,1161.0,0,pink
2005,1882,990,892,5.0,513.0,0,pink
2006,70400,33864,36536,125.0,26774.0,0,pink
2007,2380,1175,1205,11.0,553.0,0,pink
2008,2266,1124,1142,2.0,677.0,0,pink
2009,2576,1326,1250,9.0,955.0,0,pink
2010,2460,1159,1301,13.0,594.0,0,pink
2011,4100,1952,2148,20.0,1163.0,0,pink
2012,1927,927,1000,12.0,557.0,0,pink
2013,5927,2893,3034,31.0,1569.0,0,pink
2014,2654,1331,1323,9.0,893.0,0,pink
2015,12536,5714,6822,25.0,3640.0,0,pink
2016,9608,4650,4958,51.0,3170.0,0,pink
2017,8570,4164,4406,24.0,2987.0,0,pink
2018,30544,14791,15753,142.0,13165.0,0,pink
2019,10152,4663,5489,37.0,3854.0,0,pink
2020,2920,1435,1485,18.0,928.0,0,pink
2021,1837,902,935,5.0,375.0,0,pink
2022,7016,3367,3649,16.0,2380.0,0,pink
2023,4210,2095,2115,32.0,1244.0,0,pink
2024,11557,5671,5886,58.0,4337.0,0,pink
2025,5361,2684,2677,28.0,1915.0,0,pink
2026,2495,1237,1258,15.0,658.0,0,pink
2027,16288,7760,8528,25.0,4771.0,0,pink
2028,14603,7385,7218,44.0,7781.0,0,pink
2029,3883,1831,2052,9.0,1294.0,0,pink
2030,1405,682,723,7.0,345.0,0,pink
2031,4413,2204,2209,19.0,1638.0,0,pink
2032,704,351,353,0.0,71.0,0,pink
2033,30876,15012,15864,87.0,13767.0,0,pink
2034,1910,909,1001,2.0,434.0,0,pink
2035,21064,10189,10875,97.0,8220.0,0,pink
2036,2246,1049,1197,12.0,756.0,0,pink
2037,8019,3942,4077,26.0,2463.0,0,pink
2038,10802,5259,5543,34.0,4068.0,0,pink
2039,69034,33153,35881,255.0,23971.0,0,pink
2040,4055,2052,2003,12.0,1218.0,0,pink
2041,34061,15310,18751,68.0,12219.0,0,pink
2042,27878,13928,13950,164.0,8852.0,0,pink
2043,103642,51271,52371,509.0,33669.0,0,pink
2044,53477,27376,26101,236.0,14832.0,0,pink
2045,98136,48801,49335,471.0,25652.0,0,pink
2046,65936,33090,32846,157.0,19825.0,0,pink
2047,45784,23079,22705,202.0,14159.0,0,pink
2048,68472,33477,34995,342.0,19098.0,0,pink
2049,43679,22030,21649,197.0,14057.0,0,pink
2050,378294,192758,185536,1248.0,115952.0,0,pink
2051,27578,13826,13752,136.0,6305.0,0,pink
2052,38864,19498,19366,159.0,10726.0,0,pink
2053,135198,69793,65405,624.0,43275.0,0,pink
2054,203216,103092,100124,618.0,65077.0,0,pink
2055,41896,21127,20769,184.0,12731.0,0,pink
2056,104003,51585,52418,512.0,29530.0,0,pink
2057,36574,18466,18108,169.0,10050.0,0,pink
2058,42021,21409,20612,230.0,14141.0,0,pink
2059,1253783,656136,597647,4119.0,347214.0,1,purple
2060,51734,26177,25557,248.0,15012.0,0,pink
2061,38279,19260,19019,174.0,12347.0,0,pink
2062,197008,99504,97504,301.0,55765.0,0,pink
2063,75136,38273,36863,294.0,24855.0,0,pink
2064,152910,76656,76254,462.0,47184.0,0,pink
2065,28645,14685,13960,134.0,9371.0,0,pink
2066,1275333,652980,622353,2827.0,364313.0,1,purple
2067,42305,21365,20940,185.0,12479.0,0,pink
2068,30195,15393,14802,139.0,10368.0,0,pink
2069,93961,47536,46425,294.0,20398.0,0,pink
2070,165811,84219,81592,543.0,48140.0,0,pink
2071,39274,19752,19522,166.0,13585.0,0,pink
2072,812037,420309,391728,2234.0,236660.0,1,purple
2073,75690,38384,37306,296.0,21184.0,0,pink
2074,31542,15903,15639,167.0,8746.0,0,pink
2075,15307,7741,7566,82.0,4111.0,0,pink
2076,27316,13876,13440,114.0,7788.0,0,pink
2077,43007,21871,21136,189.0,13445.0,0,pink
2078,28495,14366,14129,132.0,8580.0,0,pink
2079,43859,21985,21874,191.0,5800.0,0,pink
2080,58457,29687,28770,231.0,17929.0,0,pink
2081,32524,16639,15885,150.0,11752.0,0,pink
2082,66886,34397,32489,346.0,18673.0,0,pink
2083,61215,31256,29959,250.0,16465.0,0,pink
2084,230052,117673,112379,819.0,61486.0,0,pink
2085,60622,30894,29728,290.0,24184.0,0,pink
2086,172293,87895,84398,521.0,52565.0,0,pink
2087,45307,22971,22336,180.0,12695.0,0,pink
2088,306713,155659,151054,1057.0,88869.0,0,pink
2089,432379,222799,209580,1517.0,125215.0,1,purple
2090,43988,19947,24041,145.0,11545.0,0,pink
2091,231064,118322,112742,1184.0,66842.0,0,pink
2092,65344,30644,34700,287.0,24382.0,0,pink
2093,177257,89562,87695,541.0,50471.0,0,pink
2094,23160,11686,11474,105.0,6344.0,0,pink
2095,40806,20228,20578,147.0,11285.0,0,pink
2096,104800,52953,51847,518.0,31742.0,0,pink
2097,14090,7078,7012,85.0,4204.0,0,pink
2098,532034,275880,256154,2213.0,161167.0,1,purple
2099,14702,7353,7349,62.0,4118.0,0,pink
2100,34976,17515,17461,113.0,9380.0,0,pink
2101,86076,44357,41719,323.0,31453.0,0,pink
2102,14443,5827,8616,61.0,3913.0,0,pink
2103,40709,20494,20215,153.0,10781.0,0,pink
2104,18872,9459,9413,78.0,5544.0,0,pink
2105,35985,17966,18019,134.0,10284.0,0,pink
2106,57420,27218,30202,241.0,21180.0,0,pink
2107,28214,14269,13945,138.0,9960.0,0,pink
2108,162644,82903,79741,487.0,43922.0,0,pink
2109,41207,20810,20397,208.0,11585.0,0,pink
2110,33969,17009,16960,165.0,9874.0,0,pink
2111,121324,59731,61593,547.0,39084.0,0,pink
2112,77051,36500,40551,323.0,24878.0,0,pink
2113,59299,29905,29394,263.0,17487.0,0,pink
2114,76377,38773,37604,280.0,27670.0,0,pink
2115,55475,27826,27649,250.0,15672.0,0,pink
2116,48797,24140,24657,202.0,13237.0,0,pink
2117,373475,192027,181448,1824.0,97355.0,0,pink
2118,541810,278952,262858,1853.0,142093.0,1,purple
2119,201794,103327,98467,1016.0,52290.0,0,pink
2120,92526,47115,45411,541.0,25233.0,0,pink
2121,55654,28807,26847,117.0,19813.0,0,pink
2122,28281,14390,13891,162.0,8143.0,0,pink
2123,13111,6527,6584,59.0,3693.0,0,pink
2124,226564,112534,114030,644.0,72226.0,0,pink
2125,60671,30718,29953,245.0,15414.0,0,pink
2126,116208,58518,57690,475.0,28376.0,0,pink
2127,36936,18670,18266,175.0,11879.0,0,pink
2128,129936,65941,63995,395.0,38439.0,0,pink
2129,22107,11184,10923,111.0,6635.0,0,pink
2130,22113,11144,10969,79.0,9805.0,0,pink
2131,5857,2380,3477,19.0,1887.0,0,pink
2132,13874,6568,7306,57.0,4706.0,0,pink
2133,5415,2659,2756,11.0,1174.0,0,pink
2134,22621,10399,12222,110.0,7260.0,0,pink
2135,9634,4596,5038,51.0,2945.0,0,pink
2136,45759,23531,22228,146.0,17252.0,0,pink
2137,29342,13981,15361,188.0,10113.0,0,pink
2138,136710,68788,67922,429.0,48064.0,0,pink
2139,48406,24912,23494,263.0,19263.0,0,pink
2140,48599,24736,23863,167.0,17479.0,0,pink
2141,14886,7716,7170,71.0,5099.0,0,pink
2142,2189,1094,1095,11.0,728.0,0,pink
2143,276733,138590,138143,897.0,99934.0,0,pink
2144,5618,2800,2818,25.0,2111.0,0,pink
2145,122561,58976,63585,426.0,39151.0,0,pink
2146,5929,2945,2984,37.0,1697.0,0,pink
2147,14493,7099,7394,63.0,5983.0,0,pink
2148,71160,35971,35189,361.0,22560.0,0,pink
2149,29209,14796,14413,179.0,9688.0,0,pink
2150,42112,21356,20756,222.0,13644.0,0,pink
2151,4918,2469,2449,35.0,1244.0,0,pink
2152,4072,2118,1954,12.0,1053.0,0,pink
2153,62190,31187,31003,316.0,17974.0,0,pink
2154,27823,14016,13807,159.0,8608.0,0,pink
2155,54733,27385,27348,270.0,17063.0,0,pink
2156,4418,2178,2240,18.0,1262.0,0,pink
2157,5943,2524,3419,43.0,1594.0,0,pink
2158,2721,1422,1299,14.0,892.0,0,pink
2159,3847,1960,1887,13.0,841.0,0,pink
2160,12704,6393,6311,44.0,3318.0,0,pink
2161,13460,6276,7184,68.0,3114.0,0,pink
2162,25384,12805,12579,114.0,8222.0,0,pink
2163,6223,3119,3104,31.0,1606.0,0,pink
2164,11041,5583,5458,59.0,3905.0,0,pink
2165,44880,22605,22275,238.0,15629.0,0,pink
2166,15618,7818,7800,75.0,4843.0,0,pink
2167,9001,4538,4463,59.0,2407.0,0,pink
2168,10495,5183,5312,42.0,2712.0,0,pink
2169,49909,24842,25067,120.0,15484.0,0,pink
2170,34854,17528,17326,151.0,9877.0,0,pink
2171,46044,23198,22846,178.0,13552.0,0,pink
2172,9933,4975,4958,46.0,3972.0,0,pink
2173,7718,3923,3795,46.0,2946.0,0,pink
2174,16376,8259,8117,48.0,5659.0,0,pink
2175,40980,20545,20435,176.0,13231.0,0,pink
2176,38634,19443,19191,145.0,14727.0,0,pink
2177,32966,16749,16217,177.0,9704.0,0,pink
2178,19819,10035,9784,132.0,5643.0,0,pink
2179,13875,6921,6954,85.0,5326.0,0,pink
2180,69084,35375,33709,381.0,24278.0,0,pink
2181,11411,5786,5625,49.0,3601.0,0,pink
2182,10383,5258,5125,47.0,3224.0,0,pink
2183,12115,5629,6486,65.0,4245.0,0,pink
2184,782051,399291,382760,2707.0,243521.0,1,purple
2185,38889,19729,19160,212.0,11645.0,0,pink
2186,47311,23636,23675,189.0,13814.0,0,pink
2187,31566,16046,15520,137.0,11605.0,0,pink
2188,16428,8212,8216,89.0,5058.0,0,pink
2189,81512,39621,41891,193.0,23071.0,0,pink
2190,44382,21799,22583,234.0,13776.0,0,pink
2191,38358,19590,18768,171.0,16508.0,0,pink
2192,72000,37590,34410,315.0,26654.0,0,pink
2193,11119,5680,5439,49.0,3273.0,0,pink
2194,3708,1894,1814,16.0,1121.0,0,pink
2195,90814,45568,45246,413.0,31411.0,0,pink
2196,25071,12793,12278,145.0,7685.0,0,pink
2197,41359,20977,20382,115.0,12901.0,0,pink
2198,43983,22655,21328,216.0,13459.0,0,pink
2199,21121,9808,11313,58.0,7022.0,0,pink
2200,7515,3655,3860,38.0,1824.0,0,pink
2201,642781,329122,313659,2376.0,211345.0,1,purple
2202,77850,39325,38525,302.0,26912.0,0,pink
2203,52001,26748,25253,289.0,15659.0,0,pink
2204,11432,5692,5740,61.0,3286.0,0,pink
2205,9127,4203,4924,46.0,2737.0,0,pink
2206,20967,9845,11122,88.0,6171.0,0,pink
2207,15984,7752,8232,63.0,3834.0,0,pink
2208,89780,44463,45317,94.0,22076.0,0,pink
2209,405788,206013,199775,813.0,84001.0,0,pink
2210,38562,19396,19166,65.0,6348.0,0,pink
2211,50851,25345,25506,123.0,10170.0,0,pink
2212,63308,32266,31042,198.0,14895.0,0,pink
2213,22337,11421,10916,98.0,7922.0,0,pink
2214,22507,11464,11043,71.0,4663.0,0,pink
2215,180640,91431,89209,391.0,61523.0,0,pink
2216,108323,54853,53470,475.0,25989.0,0,pink
2217,1907,995,912,6.0,326.0,0,pink
2218,7183,3552,3631,27.0,2243.0,0,pink
2219,7228,3571,3657,43.0,1974.0,0,pink
2220,23131,11603,11528,49.0,4633.0,0,pink
2221,214267,109809,104458,637.0,54357.0,0,pink
2222,23143,11133,12010,108.0,9063.0,0,pink
2223,85481,43497,41984,412.0,20884.0,0,pink
2224,66310,33168,33142,259.0,17870.0,0,pink
2225,7843,3651,4192,34.0,1669.0,0,pink
2226,368882,187032,181850,709.0,79384.0,0,pink
2227,47881,24831,23050,113.0,9310.0,0,pink
2228,122870,62247,60623,342.0,33207.0,0,pink
2229,30431,13850,16581,133.0,9680.0,0,pink
2230,335553,168220,167333,850.0,88101.0,0,pink
2231,11215,5532,5683,39.0,3408.0,0,pink
2232,798647,402994,395653,1485.0,170836.0,1,purple
2233,81427,41864,39563,169.0,20478.0,0,pink
2234,1605,734,871,6.0,399.0,0,pink
2235,26076,12937,13139,80.0,5033.0,0,pink
2236,76898,36788,40110,252.0,26393.0,0,pink
2237,26028,13117,12911,96.0,5831.0,0,pink
2238,6924,3522,3402,23.0,1571.0,0,pink
2239,25866,12948,12918,78.0,6691.0,0,pink
2240,581821,294299,287522,785.0,122080.0,1,purple
2241,1426,698,728,3.0,313.0,0,pink
2242,103820,51926,51894,270.0,22820.0,0,pink
2243,102023,51799,50224,430.0,31506.0,0,pink
2244,1225561,633931,591630,3821.0,338912.0,1,purple
2245,66331,33328,33003,389.0,18320.0,0,pink
2246,166896,85947,80949,862.0,48948.0,0,pink
2247,48611,24411,24200,290.0,12814.0,0,pink
2248,416642,211759,204883,1773.0,126585.0,1,purple
2249,123842,63223,60619,686.0,35047.0,0,pink
2250,61304,31098,30206,236.0,20652.0,0,pink
2251,626370,318987,307383,2172.0,156557.0,1,purple
2252,186566,94265,92301,836.0,54981.0,0,pink
2253,134550,68370,66180,817.0,43282.0,0,pink
2254,4686,2317,2369,25.0,1023.0,0,pink
2255,63931,32148,31783,346.0,20133.0,0,pink
2256,161443,76471,84972,402.0,44047.0,0,pink
2257,517156,262410,254746,1333.0,117858.0,1,purple
2258,38827,19865,18962,225.0,9901.0,0,pink
2259,80216,38311,41905,401.0,24329.0,0,pink
2260,39074,19796,19278,143.0,11108.0,0,pink
2261,66220,34310,31910,285.0,19644.0,0,pink
2262,86164,43970,42194,363.0,24724.0,0,pink
2263,247433,125112,122321,981.0,62836.0,0,pink
2264,274515,141651,132864,1083.0,72464.0,0,pink
2265,563527,292471,271056,2120.0,141796.0,1,purple
2266,30608,15185,15423,122.0,8585.0,0,pink
2267,275972,139716,136256,899.0,71822.0,0,pink
2268,132289,66962,65327,755.0,38869.0,0,pink
2269,7351,1544,5807,36.0,2532.0,0,pink
2270,153751,78248,75503,810.0,51431.0,0,pink
2271,14506,7146,7360,73.0,5056.0,0,pink
2272,37144,17840,19304,120.0,10705.0,0,pink
2273,45421,21369,24052,283.0,13849.0,0,pink
2274,85755,42920,42835,398.0,21809.0,0,pink
2275,44084,22197,21887,265.0,11192.0,0,pink
2276,24562,12324,12238,192.0,5721.0,0,pink
2277,211454,108974,102480,929.0,58828.0,0,pink
2278,538347,274667,263680,2121.0,150673.0,1,purple
2279,87382,45061,42321,466.0,23102.0,0,pink
2280,138674,70675,67999,576.0,45456.0,0,pink
2281,362613,185562,177051,1389.0,111488.0,0,pink
2282,317884,160912,156972,1585.0,94445.0,0,pink
2283,114859,58402,56457,595.0,34822.0,0,pink
2284,41806,20275,21531,174.0,9770.0,0,pink
2285,112630,57084,55546,542.0,28293.0,0,pink
2286,46362,23618,22744,305.0,15103.0,0,pink
2287,167586,84691,82895,599.0,48045.0,0,pink
2288,821301,421943,399358,2723.0,200042.0,1,purple
2289,18294,9448,8846,99.0,5963.0,0,pink
2290,301778,153412,148366,1275.0,99956.0,0,pink
2291,92325,45780,46545,593.0,28570.0,0,pink
2292,45924,22740,23184,200.0,10404.0,0,pink
2293,1575522,829979,745543,5546.0,393032.0,1,purple
2294,55498,27426,28072,119.0,13366.0,0,pink
2295,16937,8462,8475,103.0,3865.0,0,pink
2296,143555,70222,73333,762.0,42453.0,0,pink
2297,40466,20403,20063,170.0,9711.0,0,pink
2298,74949,35911,39038,447.0,22224.0,0,pink
2299,6177,2924,3253,38.0,1383.0,0,pink
2300,41340,20546,20794,138.0,10060.0,0,pink
2301,41226,20710,20516,222.0,10145.0,0,pink
2302,45114,20312,24802,159.0,13542.0,0,pink
2303,52376,26534,25842,272.0,13754.0,0,pink
2304,40035,20022,20013,243.0,9682.0,0,pink
2305,207547,105838,101709,734.0,63434.0,0,pink
2306,51536,24258,27278,207.0,13290.0,0,pink
2307,354751,181500,173251,1547.0,98850.0,0,pink
2308,27588,13701,13887,123.0,6530.0,0,pink
2309,444014,224599,219415,1668.0,147359.0,1,purple
2310,48900,25330,23570,194.0,17740.0,0,pink
2311,163861,84642,79219,567.0,64063.0,0,pink
2312,83075,42127,40948,114.0,26336.0,0,pink
2313,634533,326048,308485,2719.0,277243.0,1,purple
2314,126242,65132,61110,282.0,42888.0,0,pink
2315,24657,12691,11966,82.0,7842.0,0,pink
2316,166926,86162,80764,466.0,52305.0,0,pink
2317,9214,4301,4913,25.0,2454.0,0,pink
2318,195995,101430,94565,1112.0,69690.0,0,pink
2319,14600,7487,7113,81.0,4302.0,0,pink
2320,21577,11277,10300,109.0,6817.0,0,pink
2321,182658,92679,89979,438.0,54070.0,0,pink
2322,209065,105076,103989,503.0,66246.0,0,pink
2323,14713,7700,7013,64.0,3668.0,0,pink
2324,394708,203517,191191,1052.0,138166.0,0,pink
2325,56711,29182,27529,338.0,18463.0,0,pink
2326,32326,16579,15747,164.0,12705.0,0,pink
2327,46024,23382,22642,215.0,14899.0,0,pink
2328,34017,17277,16740,176.0,10814.0,0,pink
2329,37568,19610,17958,234.0,11423.0,0,pink
2330,67253,35560,31693,349.0,22308.0,0,pink
2331,30871,16304,14567,158.0,11759.0,0,pink
2332,155474,79839,75635,565.0,70420.0,0,pink
2333,26769,12406,14363,81.0,8407.0,0,pink
2334,22712,11858,10854,118.0,7670.0,0,pink
2335,138561,73962,64599,701.0,50454.0,0,pink
2336,61605,32472,29133,251.0,19771.0,0,pink
2337,498402,256549,241853,2154.0,206337.0,1,purple
2338,70264,37711,32553,335.0,26826.0,0,pink
2339,19807,9560,10247,100.0,6078.0,0,pink
2340,320915,165815,155100,1281.0,120607.0,0,pink
2341,27900,13830,14070,103.0,7297.0,0,pink
2342,64361,33100,31261,288.0,27899.0,0,pink
2343,89546,45954,43592,312.0,31513.0,0,pink
2344,66710,34255,32455,327.0,23038.0,0,pink
2345,17606,8442,9164,103.0,5163.0,0,pink
2346,286316,146821,139495,986.0,123579.0,0,pink
2347,31562,16907,14655,172.0,10690.0,0,pink
2348,27131,12895,14236,120.0,9935.0,0,pink
2349,9606,4272,5334,43.0,2761.0,0,pink
2350,38068,19532,18536,228.0,16482.0,0,pink
2351,76696,38895,37801,398.0,29023.0,0,pink
2352,88454,46930,41524,461.0,29657.0,0,pink
2353,122746,61556,61190,692.0,54553.0,0,pink
2354,408263,210428,197835,1051.0,160146.0,1,purple
2355,20299,10099,10200,89.0,4726.0,0,pink
2356,302195,155660,146535,1677.0,116768.0,0,pink
2357,106995,55521,51474,443.0,35569.0,0,pink
2358,27644,14416,13228,173.0,9928.0,0,pink
2359,31794,16487,15307,161.0,10397.0,0,pink
2360,258641,133813,124828,760.0,95472.0,0,pink
2361,2759,1311,1448,19.0,930.0,0,pink
2362,18374,8914,9460,64.0,5578.0,0,pink
2363,3437,1817,1620,17.0,957.0,0,pink
2364,6969,2898,4071,43.0,2601.0,0,pink
2365,34239,16701,17538,66.0,9461.0,0,pink
2366,38840,19780,19060,135.0,12109.0,0,pink
2367,5256,2658,2598,29.0,1689.0,0,pink
2368,2053,1035,1018,18.0,713.0,0,pink
2369,10177,5094,5083,49.0,3252.0,0,pink
2370,1435,682,753,7.0,313.0,0,pink
2371,9344,4651,4693,39.0,3629.0,0,pink
2372,3673,1797,1876,13.0,973.0,0,pink
2373,13925,7046,6879,30.0,3962.0,0,pink
2374,27993,13913,14080,108.0,10570.0,0,pink
2375,4168,2055,2113,19.0,1206.0,0,pink
2376,8573,4287,4286,28.0,2487.0,0,pink
2377,19901,9938,9963,90.0,7055.0,0,pink
2378,5506,2649,2857,40.0,1529.0,0,pink
2379,4306,2051,2255,12.0,1201.0,0,pink
2380,5779,2910,2869,46.0,3458.0,0,pink
2381,2930,1513,1417,16.0,827.0,0,pink
2382,3940,1932,2008,17.0,1079.0,0,pink
2383,6774,3370,3404,44.0,2478.0,0,pink
2384,2322,1157,1165,17.0,720.0,0,pink
2385,7217,3461,3756,53.0,2414.0,0,pink
2386,4201,2057,2144,34.0,1228.0,0,pink
2387,2082,1070,1012,12.0,533.0,0,pink
2388,6000,2909,3091,42.0,1779.0,0,pink
2389,3301,1627,1674,13.0,686.0,0,pink
2390,3397,1688,1709,6.0,742.0,0,pink
2391,1311,616,695,3.0,232.0,0,pink
2392,17617,9007,8610,65.0,5093.0,0,pink
2393,7315,3710,3605,40.0,2032.0,0,pink
2394,1331,665,666,9.0,370.0,0,pink
2395,3287,1676,1611,21.0,747.0,0,pink
2396,2029,1033,996,20.0,493.0,0,pink
2397,735,371,364,3.0,198.0,0,pink
2398,4967,2430,2537,27.0,1568.0,0,pink
2399,12574,6005,6569,30.0,2642.0,0,pink
2400,25234,12639,12595,89.0,7762.0,0,pink
2401,54914,27762,27152,115.0,17427.0,0,pink
2402,3869,1852,2017,14.0,1439.0,0,pink
2403,4895,2368,2527,15.0,956.0,0,pink
2404,5511,2740,2771,32.0,1507.0,0,pink
2405,2364,1172,1192,16.0,538.0,0,pink
2406,27424,13075,14349,69.0,8356.0,0,pink
2407,2055,1029,1026,8.0,670.0,0,pink
2408,2229,1077,1152,15.0,540.0,0,pink
2409,186749,92664,94085,565.0,64964.0,0,pink
2410,6506,3204,3302,29.0,1694.0,0,pink
2411,14335,7346,6989,64.0,4990.0,0,pink
2412,109294,54304,54990,380.0,38734.0,0,pink
2413,2907,1433,1474,19.0,819.0,0,pink
2414,2326,1147,1179,10.0,817.0,0,pink
2415,10285,4995,5290,56.0,2847.0,0,pink
2416,2388,1155,1233,8.0,681.0,0,pink
2417,6543,3263,3280,39.0,1703.0,0,pink
2418,2997,1448,1549,9.0,744.0,0,pink
2419,1331,633,698,3.0,272.0,0,pink
2420,10146,5167,4979,56.0,3884.0,0,pink
2421,5468,2749,2719,29.0,1710.0,0,pink
2422,8264,4126,4138,67.0,2285.0,0,pink
2423,15177,7484,7693,55.0,4376.0,0,pink
2424,5510,2784,2726,29.0,1506.0,0,pink
2425,22717,11012,11705,66.0,6969.0,0,pink
2426,2814,1416,1398,11.0,736.0,0,pink
2427,75775,38871,36904,400.0,27838.0,0,pink
2428,47558,24149,23409,256.0,18099.0,0,pink
2429,16112,8225,7887,105.0,5647.0,0,pink
2430,14602,6085,8517,64.0,5397.0,0,pink
2431,128443,66153,62290,553.0,49182.0,0,pink
2432,104557,53652,50905,464.0,39050.0,0,pink
2433,39687,20381,19306,190.0,15863.0,0,pink
2434,13976,7077,6899,76.0,5185.0,0,pink
2435,28018,14326,13692,180.0,11612.0,0,pink
2436,56391,28773,27618,381.0,21469.0,0,pink
2437,39929,20112,19817,146.0,13150.0,0,pink
2438,17150,8943,8207,104.0,7106.0,0,pink
2439,31613,16252,15361,218.0,11205.0,0,pink
2440,7686,3915,3771,63.0,2654.0,0,pink
2441,35336,18231,17105,245.0,14746.0,0,pink
2442,54531,27891,26640,302.0,20927.0,0,pink
2443,14499,7592,6907,100.0,6491.0,0,pink
2444,58634,29888,28746,350.0,19480.0,0,pink
2445,684017,354069,329948,1898.0,234737.0,1,purple
2446,19601,9851,9750,117.0,7743.0,0,pink
2447,11683,5895,5788,76.0,4562.0,0,pink
2448,51988,26530,25458,273.0,20117.0,0,pink
2449,37576,19419,18157,234.0,15687.0,0,pink
2450,39692,20182,19510,232.0,14208.0,0,pink
2451,17994,9101,8893,145.0,7050.0,0,pink
2452,41512,21098,20414,206.0,16091.0,0,pink
2453,49175,25487,23688,303.0,21831.0,0,pink
2454,29167,14921,14246,219.0,11494.0,0,pink
2455,23013,11548,11465,128.0,8257.0,0,pink
2456,68669,35119,33550,418.0,27875.0,0,pink
2457,13331,6760,6571,83.0,4624.0,0,pink
2458,63740,32599,31141,395.0,24566.0,0,pink
2459,357546,185099,172447,1303.0,121521.0,0,pink
2460,6585,3292,3293,44.0,2628.0,0,pink
2461,25562,11474,14088,150.0,9510.0,0,pink
2462,25771,13165,12606,175.0,10850.0,0,pink
2463,56402,28820,27582,377.0,21599.0,0,pink
2464,17779,9533,8246,109.0,8024.0,0,pink
2465,27859,14413,13446,190.0,11099.0,0,pink
2466,32279,16725,15554,185.0,10173.0,0,pink
2467,24678,11768,12910,125.0,8513.0,0,pink
2468,8176,4110,4066,66.0,3053.0,0,pink
2469,18318,9305,9013,87.0,6123.0,0,pink
2470,11615,5789,5826,72.0,3887.0,0,pink
2471,53247,27148,26099,314.0,19691.0,0,pink
2472,17789,8107,9682,111.0,6086.0,0,pink
2473,456185,234518,221667,1632.0,159010.0,1,purple
2474,7526,2884,4642,50.0,3175.0,0,pink
2475,26297,12792,13505,120.0,9391.0,0,pink
2476,42937,21849,21088,233.0,16942.0,0,pink
2477,11956,6221,5735,68.0,4156.0,0,pink
2478,33711,17091,16620,190.0,11767.0,0,pink
2479,51610,26376,25234,236.0,18722.0,0,pink
2480,23487,11943,11544,163.0,10353.0,0,pink
2481,97682,51545,46137,498.0,39525.0,0,pink
2482,28417,14585,13832,145.0,11057.0,0,pink
2483,32269,16392,15877,138.0,12702.0,0,pink
2484,89776,46665,43111,394.0,34959.0,0,pink
2485,52773,27236,25537,287.0,19964.0,0,pink
2486,25903,13218,12685,149.0,9542.0,0,pink
2487,11962,6025,5937,67.0,4158.0,0,pink
2488,45876,23175,22701,283.0,18198.0,0,pink
2489,196387,98264,98123,646.0,63290.0,0,pink
2490,6322,3221,3101,44.0,2736.0,0,pink
2491,21596,9546,12050,99.0,7807.0,0,pink
2492,30520,15873,14647,229.0,13427.0,0,pink
2493,22004,11147,10857,136.0,8652.0,0,pink
2494,7912,3934,3978,61.0,2798.0,0,pink
2495,5088,2513,2575,41.0,2189.0,0,pink
2496,16782,8413,8369,94.0,5628.0,0,pink
2497,76440,38733,37707,331.0,29649.0,0,pink
2498,32628,16522,16106,179.0,11774.0,0,pink
2499,52897,26966,25931,279.0,19570.0,0,pink
2500,69344,35057,34287,342.0,25966.0,0,pink
2501,307128,155682,151446,1000.0,116550.0,0,pink
2502,21954,11099,10855,145.0,12151.0,0,pink
2503,14730,7399,7331,98.0,5146.0,0,pink
2504,96287,49006,47281,457.0,36497.0,0,pink
2505,937005,491011,445994,3724.0,293136.0,1,purple
2506,19458,9783,9675,100.0,7304.0,0,pink
2507,13301,6670,6631,72.0,3766.0,0,pink
2508,156734,80684,76050,825.0,59959.0,0,pink
2509,179473,91662,87811,825.0,65285.0,0,pink
2510,61446,31206,30240,291.0,21981.0,0,pink
2511,9573,4271,5302,49.0,4726.0,0,pink
2512,17780,8885,8895,107.0,6797.0,0,pink
2513,19293,9737,9556,85.0,6979.0,0,pink
2514,5704,2822,2882,51.0,2250.0,0,pink
2515,40454,20363,20091,198.0,15763.0,0,pink
2516,127055,65204,61851,562.0,49738.0,0,pink
2517,16649,7463,9186,89.0,6882.0,0,pink
2518,33626,17085,16541,183.0,11818.0,0,pink
2519,26580,13598,12982,150.0,9844.0,0,pink
2520,218648,111627,107021,464.0,75927.0,0,pink
2521,132663,67607,65056,542.0,51407.0,0,pink
2522,57863,22451,35412,257.0,12229.0,0,pink
2523,17818,8716,9102,74.0,5084.0,0,pink
2524,87607,44948,42659,505.0,17031.0,0,pink
2525,24763,12737,12026,97.0,5563.0,0,pink
2526,8789,4463,4326,30.0,2638.0,0,pink
2527,1916,956,960,10.0,706.0,0,pink
2528,48828,24430,24398,240.0,15793.0,0,pink
2529,29565,14881,14684,86.0,7008.0,0,pink
2530,7092,3452,3640,39.0,1788.0,0,pink
2531,21763,10731,11032,80.0,4317.0,0,pink
2532,82577,40563,42014,255.0,27363.0,0,pink
2533,3591,1839,1752,33.0,937.0,0,pink
2534,32691,12780,19911,159.0,10327.0,0,pink
2535,342236,171318,170918,950.0,86441.0,0,pink
2536,1925865,975835,950030,6505.0,696535.0,2,dark purple
2537,11279,5498,5781,35.0,3270.0,0,pink
2538,665,319,346,2.0,126.0,0,pink
2539,18122,9187,8935,75.0,4878.0,0,pink
2540,93858,46583,47275,471.0,24678.0,0,pink
2541,353999,174939,179060,1043.0,117224.0,0,pink
2542,219193,108119,111074,490.0,74935.0,0,pink
2543,9216,4658,4558,34.0,1545.0,0,pink
2544,1546,715,831,8.0,584.0,0,pink
2545,7180,3456,3724,55.0,2112.0,0,pink
2546,37834,19060,18774,239.0,15254.0,0,pink
2547,17863,8886,8977,68.0,6102.0,0,pink
2548,45750,23108,22642,185.0,13615.0,0,pink
2549,41401,20508,20893,186.0,17739.0,0,pink
2550,21807,10745,11062,56.0,7090.0,0,pink
2551,13770,7007,6763,80.0,3501.0,0,pink
2552,421750,216962,204788,2400.0,142297.0,1,purple
2553,12813,6593,6220,78.0,3576.0,0,pink
2554,6032,3212,2820,38.0,1757.0,0,pink
2555,30087,15395,14692,204.0,8923.0,0,pink
2556,7787,3882,3905,48.0,2815.0,0,pink
2557,40292,19915,20377,77.0,12813.0,0,pink
2558,51903,25296,26607,261.0,9814.0,0,pink
2559,7226,2777,4449,35.0,3215.0,0,pink
2560,10387,5192,5195,49.0,2529.0,0,pink
2561,2904,1413,1491,25.0,1048.0,0,pink
2562,3275,1669,1606,21.0,1163.0,0,pink
2563,8391,4171,4220,77.0,2077.0,0,pink
2564,944350,480102,464248,1635.0,275656.0,1,purple
2565,2996,1500,1496,17.0,902.0,0,pink
2566,21022,10484,10538,68.0,4573.0,0,pink
2567,135097,68304,66793,583.0,43207.0,0,pink
2568,13495,6757,6738,82.0,4052.0,0,pink
2569,4233,1431,2802,15.0,1407.0,0,pink
2570,39571,19911,19660,146.0,8542.0,0,pink
2571,75389,37759,37630,234.0,22411.0,0,pink
2572,1623,831,792,9.0,389.0,0,pink
2573,4839,2328,2511,33.0,1744.0,0,pink
2574,3633,1862,1771,22.0,1503.0,0,pink
2575,5861,2940,2921,48.0,2318.0,0,pink
2576,2241,1010,1231,14.0,597.0,0,pink
2577,7243,3448,3795,73.0,2564.0,0,pink
2578,2586552,1311326,1275226,7162.0,694798.0,2,dark purple
2579,12964,5729,7235,101.0,3567.0,0,pink
2580,20435,9858,10577,114.0,7405.0,0,pink
2581,18899,9392,9507,131.0,6331.0,0,pink
2582,5215,2688,2527,28.0,2065.0,0,pink
2583,807047,409907,397140,1461.0,224806.0,1,purple
2584,2216,1073,1143,16.0,539.0,0,pink
2585,10663,5477,5186,53.0,6313.0,0,pink
2586,3387,1753,1634,26.0,1329.0,0,pink
2587,11355,5597,5758,74.0,4470.0,0,pink
2588,18270,9025,9245,120.0,3433.0,0,pink
2589,158342,78093,80249,755.0,43970.0,0,pink
2590,2055,993,1062,12.0,586.0,0,pink
2591,837654,425972,411682,3905.0,255229.0,1,purple
2592,168838,85654,83184,618.0,57991.0,0,pink
2593,41482,21266,20216,132.0,9978.0,0,pink
2594,17299,9110,8189,70.0,4695.0,0,pink
2595,34175,16141,18034,197.0,8220.0,0,pink
2596,25066,12715,12351,118.0,5489.0,0,pink
2597,3883,2004,1879,27.0,754.0,0,pink
2598,5872,2987,2885,51.0,2359.0,0,pink
2599,1408,696,712,12.0,254.0,0,pink
2600,739342,376165,363177,1245.0,245291.0,1,purple
2601,10679,5317,5362,46.0,2676.0,0,pink
2602,19709,9546,10163,87.0,4473.0,0,pink
2603,19394,7814,11580,95.0,6859.0,0,pink
2604,20321,10001,10320,86.0,2397.0,0,pink
2605,327089,165820,161269,911.0,119676.0,0,pink
2606,6288,2218,4070,31.0,1518.0,0,pink
2607,26208,13477,12731,125.0,6318.0,0,pink
2608,1430,643,787,3.0,274.0,0,pink
2609,7531,3797,3734,34.0,1613.0,0,pink
2610,20667,10219,10448,107.0,5406.0,0,pink
2611,22685,10782,11903,138.0,7268.0,0,pink
2612,128560,65823,62737,692.0,31681.0,0,pink
2613,123494,63286,60208,734.0,27099.0,0,pink
2614,27630,12738,14892,129.0,10350.0,0,pink
2615,155137,78287,76850,429.0,45870.0,0,pink
2616,34113,16362,17751,261.0,8443.0,0,pink
2617,3074,1528,1546,25.0,1308.0,0,pink
2618,8269,4199,4070,38.0,2113.0,0,pink
2619,5547,2764,2783,33.0,2359.0,0,pink
2620,3952,2014,1938,21.0,648.0,0,pink
2621,56379,29037,27342,266.0,14605.0,0,pink
2622,4602523,2314228,2288295,11595.0,1272036.0,2,dark purple
2623,66645,34089,32556,254.0,15773.0,0,pink
2624,5767,2356,3411,5.0,1555.0,0,pink
2625,5809,2738,3071,40.0,1131.0,0,pink
2626,204150,102514,101636,571.0,78826.0,0,pink
2627,4061,2096,1965,9.0,1477.0,0,pink
2628,80460,41363,39097,449.0,18435.0,0,pink
2629,849389,433946,415443,4032.0,266997.0,1,purple
2630,35399,17796,17603,205.0,10152.0,0,pink
2631,23162,11734,11428,170.0,9437.0,0,pink
2632,56901,28897,28004,297.0,15021.0,0,pink
2633,36240,18439,17801,197.0,8716.0,0,pink
2634,22955,10523,12432,119.0,5194.0,0,pink
2635,36667,15935,20732,192.0,8193.0,0,pink
2636,4098,2079,2019,18.0,1293.0,0,pink
2637,92152,46873,45279,376.0,19777.0,0,pink
2638,21571,10774,10797,152.0,7651.0,0,pink
2639,1524,688,836,3.0,622.0,0,pink
2640,8842,3855,4987,31.0,1711.0,0,pink
2641,14820,7594,7226,62.0,4008.0,0,pink
2642,35504,18003,17501,206.0,8951.0,0,pink
2643,2234,1120,1114,10.0,293.0,0,pink
2644,255210,124550,130660,880.0,63088.0,0,pink
2645,5282,2732,2550,23.0,3806.0,0,pink
2646,41192,21014,20178,229.0,14281.0,0,pink
2647,163475,81907,81568,784.0,52266.0,0,pink
2648,19891,7384,12507,98.0,6022.0,0,pink
2649,15387,6254,9133,75.0,6601.0,0,pink
2650,118910,60550,58360,564.0,42483.0,0,pink
2651,41982,21567,20415,137.0,9871.0,0,pink
2652,595,309,286,2.0,104.0,0,pink
2653,749,422,327,4.0,223.0,0,pink
2654,51365,26479,24886,204.0,11065.0,0,pink
2655,4408,2254,2154,16.0,965.0,0,pink
2656,228,110,118,0.0,60.0,0,pink
2657,3675,1385,2290,14.0,842.0,0,pink
2658,31425,15373,16052,157.0,9316.0,0,pink
2659,3733,1880,1853,26.0,702.0,0,pink
2660,7409,3001,4408,50.0,2738.0,0,pink
2661,49532,25615,23917,285.0,11994.0,0,pink
2662,13262,6552,6710,130.0,5156.0,0,pink
2663,20640,10453,10187,95.0,6390.0,0,pink
2664,19941,10257,9684,124.0,4949.0,0,pink
2665,16952,8394,8558,68.0,5236.0,0,pink
2666,17098,8496,8602,96.0,4313.0,0,pink
2667,81862,41423,40439,416.0,22381.0,0,pink
2668,23515,11459,12056,138.0,6112.0,0,pink
2669,3469,1629,1840,21.0,813.0,0,pink
2670,12123,5489,6634,43.0,2425.0,0,pink
2671,20640,10502,10138,101.0,5119.0,0,pink
2672,102,44,58,1.0,400.0,0,pink
2673,301454,152823,148631,1408.0,113227.0,0,pink
2674,5808,2831,2977,42.0,1704.0,0,pink
2675,14128,6001,8127,59.0,4401.0,0,pink
2676,10083,5168,4915,63.0,2037.0,0,pink
2677,5614,2680,2934,26.0,1474.0,0,pink
2678,4161,2015,2146,13.0,1104.0,0,pink
2679,36743,18424,18319,185.0,10323.0,0,pink
2680,57970,29234,28736,496.0,24544.0,0,pink
2681,8098,3838,4260,51.0,1965.0,0,pink
2682,248429,127070,121359,978.0,74905.0,0,pink
2683,662,275,387,10.0,187.0,0,pink
2684,49334,23783,25551,215.0,12760.0,0,pink
2685,2123,1006,1117,13.0,677.0,0,pink
2686,164194,81651,82543,526.0,47935.0,0,pink
2687,24664,12321,12343,111.0,6000.0,0,pink
2688,4902,2573,2329,39.0,1653.0,0,pink
2689,8558,3175,5383,52.0,2111.0,0,pink
2690,19409,10006,9403,136.0,5373.0,0,pink
2691,554445,279841,274604,1389.0,171735.0,1,purple
2692,21801,10363,11438,118.0,6355.0,0,pink
2693,12424,6443,5981,75.0,3013.0,0,pink
2694,1156,576,580,13.0,327.0,0,pink
2695,65558,34193,31365,282.0,14885.0,0,pink
2696,48583,24738,23845,240.0,14447.0,0,pink
2697,14057,6824,7233,65.0,1980.0,0,pink
2698,14966,7297,7669,108.0,3539.0,0,pink
2699,360486,182466,178020,1586.0,119838.0,0,pink
2700,10348,5118,5230,52.0,2685.0,0,pink
2701,2090,945,1145,6.0,660.0,0,pink
2702,84047,42417,41630,381.0,17401.0,0,pink
2703,28317,14330,13987,159.0,8024.0,0,pink
2704,23440,11942,11498,149.0,5761.0,0,pink
2705,129802,65354,64448,494.0,40275.0,0,pink
2706,9852,4793,5059,56.0,2694.0,0,pink
2707,15797,6787,9010,72.0,3940.0,0,pink
2708,47837,21959,25878,266.0,9275.0,0,pink
2709,120899,58604,62295,782.0,43250.0,0,pink
2710,7123,3626,3497,42.0,1320.0,0,pink
2711,11473,5605,5868,62.0,2265.0,0,pink
2712,132475,67392,65083,514.0,29926.0,0,pink
2713,3752,1801,1951,19.0,1025.0,0,pink
2714,3389,1963,1426,25.0,1023.0,0,pink
2715,12275,6289,5986,75.0,2787.0,0,pink
2716,15125,6436,8689,78.0,5805.0,0,pink
2717,7236,3650,3586,43.0,2306.0,0,pink
2718,885,484,401,2.0,198.0,0,pink
2719,16890,8594,8296,84.0,5355.0,0,pink
2720,93642,47475,46167,289.0,31644.0,0,pink
2721,10310,5077,5233,75.0,2775.0,0,pink
2722,53595,25216,28379,249.0,12795.0,0,pink
2723,10458,5386,5072,97.0,1697.0,0,pink
2724,8327,4242,4085,50.0,1217.0,0,pink
2725,27819,14101,13718,113.0,6683.0,0,pink
2726,67046,33325,33721,366.0,14533.0,0,pink
2727,5962,2889,3073,39.0,1637.0,0,pink
2728,3061,1519,1542,9.0,679.0,0,pink
2729,17239,7814,9425,108.0,7386.0,0,pink
2730,3311,1541,1770,12.0,1101.0,0,pink
2731,25478,12906,12572,151.0,5386.0,0,pink
2732,3058,1484,1574,16.0,540.0,0,pink
2733,225015,116285,108730,1019.0,56949.0,0,pink
2734,8743,4551,4192,37.0,2232.0,0,pink
2735,63894,32821,31073,392.0,24524.0,0,pink
2736,9372,4564,4808,58.0,2249.0,0,pink
2737,1141,519,622,9.0,341.0,0,pink
2738,1385,655,730,7.0,424.0,0,pink
2739,3865,1749,2116,14.0,994.0,0,pink
2740,7484,3448,4036,34.0,2697.0,0,pink
2741,2019977,1031212,988765,6353.0,684864.0,2,dark purple
2742,136348,69630,66718,772.0,40772.0,0,pink
2743,862,433,429,3.0,164.0,0,pink
2744,12615,6100,6515,88.0,2941.0,0,pink
2745,1567,873,694,10.0,295.0,0,pink
2746,32730,16684,16046,137.0,10251.0,0,pink
2747,117466,59123,58343,484.0,40951.0,0,pink
2748,1203166,595810,607356,1884.0,331765.0,1,purple
2749,14569,7558,7011,79.0,3256.0,0,pink
2750,21496,9758,11738,92.0,5708.0,0,pink
2751,40769,20545,20224,194.0,9097.0,0,pink
2752,3634,1791,1843,19.0,1010.0,0,pink
2753,27009,13926,13083,156.0,11533.0,0,pink
2754,49027,24102,24925,312.0,15866.0,0,pink
2755,54368,27749,26619,304.0,12710.0,0,pink
2756,91970,46971,44999,432.0,23161.0,0,pink
2757,71539,29897,41642,223.0,23849.0,0,pink
2758,49987,25118,24869,115.0,11757.0,0,pink
2759,11586,5722,5864,51.0,3344.0,0,pink
2760,34796,17537,17259,158.0,11020.0,0,pink
2761,272053,139147,132906,1081.0,111458.0,0,pink
2762,41551,21156,20395,228.0,11621.0,0,pink
2763,5482,2638,2844,31.0,1372.0,0,pink
2764,131818,63493,68325,753.0,41169.0,0,pink
2765,12906,6559,6347,91.0,4239.0,0,pink
2766,21754,10073,11681,137.0,8837.0,0,pink
2767,527057,267614,259443,1005.0,170424.0,1,purple
2768,48198,24001,24197,167.0,12872.0,0,pink
2769,7802,3825,3977,37.0,2252.0,0,pink
2770,64639,32215,32424,292.0,19744.0,0,pink
2771,43815,22008,21807,309.0,9786.0,0,pink
2772,8571,4133,4438,47.0,1646.0,0,pink
2773,18114,9184,8930,101.0,4488.0,0,pink
2774,14369,7192,7177,57.0,4504.0,0,pink
2775,12131,5923,6208,70.0,4546.0,0,pink
2776,6443,3163,3280,0.0,1.0,0,pink
2777,53001,26114,26887,0.0,0.0,0,pink
2778,122336,60982,61354,0.0,46.0,0,pink
2779,20356,10301,10055,0.0,2.0,0,pink
2780,612,253,359,0.0,0.0,0,pink
2781,340621,169037,171584,458.0,119494.0,0,pink
2782,20219,9907,10312,0.0,3.0,0,pink
2783,10248,5014,5234,0.0,3.0,0,pink
2784,5017,2423,2594,0.0,2.0,0,pink
2785,9616,4837,4779,0.0,5.0,0,pink
2786,49691,24857,24834,0.0,17.0,0,pink
2787,10948,5358,5590,0.0,0.0,0,pink
2788,7350,3657,3693,0.0,3.0,0,pink
2789,12733,6188,6545,0.0,0.0,0,pink
2790,11391,5567,5824,0.0,0.0,0,pink
2791,1904,884,1020,0.0,0.0,0,pink
2792,2350,1198,1152,0.0,0.0,0,pink
2793,1120805,558262,562543,1820.0,408568.0,1,purple
2794,15281,7611,7670,53.0,5111.0,0,pink
2795,29366,13954,15412,0.0,0.0,0,pink
2796,21118,10303,10815,0.0,0.0,0,pink
2797,40511,19745,20766,28.0,15921.0,0,pink
2798,65185,32314,32871,115.0,24988.0,0,pink
2799,36323,17827,18496,0.0,6.0,0,pink
2800,590440,292184,298256,883.0,225635.0,1,purple
2801,30523,14979,15544,40.0,12183.0,0,pink
2802,160537,81037,79500,1.0,83.0,0,pink
2803,2694,1297,1397,0.0,0.0,0,pink
2804,247731,123329,124402,0.0,0.0,0,pink
2805,36939,18667,18272,33.0,6984.0,0,pink
2806,35920,18309,17611,94.0,12204.0,0,pink
2807,30425,15207,15218,41.0,6594.0,0,pink
2808,162052,82505,79547,230.0,39595.0,0,pink
2809,6208,3073,3135,4.0,1484.0,0,pink
2810,49025,24668,24357,86.0,11677.0,0,pink
2811,6965,3489,3476,8.0,1297.0,0,pink
2812,25268,12677,12591,30.0,4414.0,0,pink
2813,28937,14580,14357,18.0,5922.0,0,pink
2814,26911,13386,13525,49.0,7156.0,0,pink
2815,59273,30194,29079,99.0,17068.0,0,pink
2816,58477,29661,28816,80.0,14242.0,0,pink
2817,43150,22213,20937,53.0,9040.0,0,pink
2818,55427,28375,27052,68.0,11733.0,0,pink
2819,32742,16881,15861,120.0,9105.0,0,pink
2820,106355,55499,50856,223.0,25321.0,0,pink
2821,156505,81159,75346,258.0,45754.0,0,pink
2822,15286,7766,7520,122.0,5003.0,0,pink
2823,12854,6202,6652,70.0,3589.0,0,pink
2824,31882,16524,15358,118.0,9660.0,0,pink
2825,15577,8014,7563,63.0,5028.0,0,pink
2826,231803,115984,115819,384.0,66561.0,0,pink
2827,74701,36804,37897,277.0,25651.0,0,pink
2828,4393,2083,2310,26.0,1192.0,0,pink
2829,77908,39602,38306,288.0,22325.0,0,pink
2830,6447,2905,3542,27.0,2456.0,0,pink
2831,33222,16834,16388,122.0,10008.0,0,pink
2832,16843,8839,8004,115.0,6247.0,0,pink
2833,16665,7773,8892,56.0,4097.0,0,pink
2834,22138,10983,11155,154.0,6217.0,0,pink
2835,17004,7582,9422,65.0,4997.0,0,pink
2836,6399,3554,2845,50.0,2538.0,0,pink
2837,55170,28434,26736,250.0,17830.0,0,pink
2838,30184,15046,15138,98.0,9146.0,0,pink
2839,29738,14775,14963,188.0,9810.0,0,pink
2840,6995,3554,3441,33.0,1735.0,0,pink
2841,12095,6114,5981,55.0,3463.0,0,pink
2842,47042,24212,22830,114.0,13788.0,0,pink
2843,237820,121632,116188,581.0,64119.0,0,pink
2844,339447,175913,163534,893.0,99776.0,0,pink
2845,14365,7032,7333,61.0,3581.0,0,pink
2846,17593,9540,8053,116.0,6455.0,0,pink
2847,5582,2840,2742,33.0,2115.0,0,pink
2848,5113,2612,2501,27.0,1476.0,0,pink
2849,50450,25201,25249,191.0,14779.0,0,pink
2850,9786,4956,4830,31.0,1857.0,0,pink
2851,41512,22471,19041,316.0,15482.0,0,pink
2852,14960,7375,7585,73.0,4944.0,0,pink
2853,28308,14298,14010,111.0,7517.0,0,pink
2854,5381,2973,2408,59.0,1729.0,0,pink
2855,11036,6074,4962,44.0,2855.0,0,pink
2856,1143529,576883,566646,1785.0,260688.0,1,purple
2857,23865,12064,11801,56.0,2790.0,0,pink
2858,14067,7050,7017,34.0,3572.0,0,pink
2859,69115,34832,34283,174.0,16644.0,0,pink
2860,15666,7842,7824,56.0,3727.0,0,pink
2861,26282,14277,12005,57.0,6906.0,0,pink
2862,56233,28701,27532,236.0,14281.0,0,pink
2863,8211,4600,3611,64.0,2917.0,0,pink
2864,85153,42748,42405,297.0,26693.0,0,pink
2865,28469,15405,13064,63.0,7417.0,0,pink
2866,6638,3464,3174,92.0,3677.0,0,pink
2867,16814,8562,8252,64.0,5416.0,0,pink
2868,37161,18833,18328,126.0,9647.0,0,pink
2869,22482,11353,11129,66.0,5781.0,0,pink
2870,15811,7816,7995,105.0,5712.0,0,pink
2871,19410,9960,9450,68.0,5156.0,0,pink
2872,11659,4323,7336,53.0,4150.0,0,pink
2873,34779,18141,16638,196.0,9651.0,0,pink
2874,135583,70308,65275,378.0,38549.0,0,pink
2875,104449,53227,51222,359.0,29035.0,0,pink
2876,53391,27811,25580,207.0,16138.0,0,pink
2877,325642,171395,154247,1127.0,90906.0,0,pink
2878,51588,26722,24866,342.0,16488.0,0,pink
2879,2214,1171,1043,7.0,504.0,0,pink
2880,22408,12033,10375,133.0,8082.0,0,pink
2881,36372,18628,17744,138.0,9216.0,0,pink
2882,74153,38269,35884,160.0,21373.0,0,pink
2883,25890,12894,12996,61.0,6934.0,0,pink
2884,16497,8384,8113,56.0,4737.0,0,pink
2885,7052,3514,3538,18.0,1498.0,0,pink
2886,10804,5696,5108,43.0,2345.0,0,pink
2887,24134,11526,12608,135.0,8491.0,0,pink
2888,7110,3200,3910,42.0,3500.0,0,pink
2889,385143,194406,190737,461.0,97441.0,0,pink
2890,35380,18004,17376,108.0,8965.0,0,pink
2891,12278,6017,6261,48.0,3387.0,0,pink
2892,80131,42616,37515,360.0,26102.0,0,pink
2893,13139,6789,6350,50.0,3240.0,0,pink
2894,41457,20682,20775,89.0,11964.0,0,pink
2895,16423,7855,8568,34.0,4925.0,0,pink
2896,13101,7234,5867,140.0,4842.0,0,pink
2897,8796,4504,4292,31.0,2079.0,0,pink
2898,30847,15938,14909,152.0,7869.0,0,pink
2899,10700,5518,5182,57.0,2542.0,0,pink
2900,97997,47259,50738,217.0,25339.0,0,pink
2901,14812,7614,7198,46.0,3499.0,0,pink
2902,21103,10500,10603,50.0,6069.0,0,pink
2903,180145,92924,87221,465.0,49672.0,0,pink
2904,245592,117299,128293,554.0,53884.0,0,pink
2905,11957,6258,5699,81.0,2935.0,0,pink
2906,12223,6256,5967,52.0,2735.0,0,pink
2907,3990,2198,1792,27.0,1851.0,0,pink
2908,15500,7097,8403,109.0,5700.0,0,pink
2909,35612,18194,17418,117.0,9396.0,0,pink
2910,23749,12074,11675,138.0,7053.0,0,pink
2911,17859,8963,8896,126.0,5071.0,0,pink
2912,31827,17176,14651,167.0,10927.0,0,pink
2913,61676,31435,30241,260.0,19175.0,0,pink
2914,12039,6183,5856,32.0,2980.0,0,pink
2915,95311,49392,45919,379.0,26601.0,0,pink
2916,28574,13325,15249,68.0,6397.0,0,pink
2917,22956,11463,11493,93.0,6880.0,0,pink
2918,37894,17282,20612,95.0,11634.0,0,pink
2919,456749,228798,227951,868.0,128018.0,1,purple
2920,34234,17096,17138,171.0,10926.0,0,pink
2921,17630,9205,8425,60.0,6439.0,0,pink
2922,7332,3702,3630,17.0,1465.0,0,pink
2923,8878,3950,4928,57.0,3841.0,0,pink
2924,223787,117565,106222,593.0,61940.0,0,pink
2925,93583,48733,44850,385.0,28995.0,0,pink
2926,99621,51846,47775,463.0,28752.0,0,pink
2927,22509,11324,11185,97.0,5303.0,0,pink
2928,79444,40534,38910,292.0,19117.0,0,pink
2929,27408,14037,13371,149.0,9617.0,0,pink
2930,25519,13617,11902,128.0,8706.0,0,pink
2931,22009,10920,11089,145.0,7713.0,0,pink
2932,43045,22001,21044,272.0,14068.0,0,pink
2933,31059,15758,15301,215.0,12167.0,0,pink
2934,17939,8594,9345,110.0,4517.0,0,pink
2935,131412,66842,64570,361.0,35354.0,0,pink
2936,144012,71472,72540,216.0,42026.0,0,pink
2937,24452,13254,11198,151.0,8368.0,0,pink
2938,89160,46075,43085,369.0,24369.0,0,pink
2939,6600,3397,3203,24.0,1460.0,0,pink
2940,11486,4655,6831,50.0,3172.0,0,pink
2941,42080,21239,20841,232.0,14180.0,0,pink
2942,450135,228850,221285,971.0,115384.0,1,purple
2943,39449,19783,19666,190.0,11512.0,0,pink
2944,54406,27555,26851,273.0,18444.0,0,pink
2945,21926,11266,10660,89.0,8066.0,0,pink
2946,17638,9009,8629,62.0,4359.0,0,pink
2947,14788,8061,6727,27.0,2461.0,0,pink
2948,27789,14216,13573,106.0,8228.0,0,pink
2949,39025,18535,20490,252.0,14340.0,0,pink
2950,28940,14828,14112,175.0,9890.0,0,pink
2951,67587,34356,33231,138.0,13786.0,0,pink
2952,19452,9608,9844,46.0,5674.0,0,pink
2953,22337,11616,10721,90.0,5613.0,0,pink
2954,194168,97029,97139,565.0,62615.0,0,pink
2955,75757,37993,37764,203.0,24220.0,0,pink
2956,74487,37630,36857,209.0,16067.0,0,pink
2957,465384,235292,230092,1062.0,112752.0,1,purple
2958,4001,2071,1930,20.0,773.0,0,pink
2959,105112,53175,51937,450.0,27342.0,0,pink
2960,41371,20550,20821,90.0,13328.0,0,pink
2961,7576,3692,3884,34.0,1849.0,0,pink
2962,90660,43515,47145,237.0,37175.0,0,pink
2963,2224,1125,1099,9.0,509.0,0,pink
2964,94860,46761,48099,245.0,31545.0,0,pink
2965,71967,34986,36981,262.0,20444.0,0,pink
2966,81636,40855,40781,127.0,13789.0,0,pink
2967,30856,15502,15354,36.0,4902.0,0,pink
2968,2163257,1080317,1082940,3542.0,550022.0,2,dark purple
2969,262475,128381,134094,459.0,52814.0,0,pink
2970,44825,22270,22555,94.0,10651.0,0,pink
2971,21396,10645,10751,63.0,4337.0,0,pink
2972,76947,38438,38509,315.0,20826.0,0,pink
2973,10435,5124,5311,32.0,2704.0,0,pink
2974,62627,30214,32413,203.0,15814.0,0,pink
2975,41638,20577,21061,140.0,10594.0,0,pink
2976,21281,10641,10640,78.0,5015.0,0,pink
2977,13219,6525,6694,44.0,3032.0,0,pink
2978,859840,432269,427571,1734.0,246723.0,1,purple
2979,16473,8517,7956,5.0,2015.0,0,pink
2980,123907,62531,61376,282.0,28985.0,0,pink
2981,11620,5759,5861,19.0,1806.0,0,pink
2982,786620,392094,394526,1453.0,207630.0,1,purple
2983,497875,250969,246906,1695.0,155763.0,1,purple
2984,44214,22270,21944,174.0,10143.0,0,pink
2985,274684,140282,134402,578.0,63426.0,0,pink
2986,4189,2189,2000,11.0,668.0,0,pink
2987,60236,29406,30830,200.0,19271.0,0,pink
2988,216812,109584,107228,388.0,49285.0,0,pink
2989,48593,23844,24749,107.0,11231.0,0,pink
2990,249325,124425,124900,884.0,83937.0,0,pink
2991,16730,8587,8143,86.0,6203.0,0,pink
2992,113495,57482,56013,361.0,45052.0,0,pink
2993,22817,11467,11350,117.0,8726.0,0,pink
2994,14282,7157,7125,54.0,5033.0,0,pink
2995,22772,11601,11171,128.0,6293.0,0,pink
2996,95318,48579,46739,472.0,34027.0,0,pink
2997,7396,3754,3642,15.0,2288.0,0,pink
2998,8785,4397,4388,56.0,2746.0,0,pink
2999,8536,3844,4692,22.0,2544.0,0,pink
3000,44126,22027,22099,246.0,16722.0,0,pink
3001,8205,3472,4733,27.0,2564.0,0,pink
3002,11641,5828,5813,64.0,4827.0,0,pink
3003,35347,18144,17203,195.0,12896.0,0,pink
3004,23363,11383,11980,77.0,7327.0,0,pink
3005,29680,15304,14376,169.0,8388.0,0,pink
3006,13842,6730,7112,55.0,5740.0,0,pink
3007,68209,34908,33301,313.0,26293.0,0,pink
3008,29018,14601,14417,167.0,8839.0,0,pink
3009,56179,28436,27743,164.0,18358.0,0,pink
3010,185710,96227,89483,929.0,59564.0,0,pink
3011,16276,8074,8202,100.0,7007.0,0,pink
3012,21078,10539,10539,100.0,7619.0,0,pink
3013,33801,17129,16672,208.0,12925.0,0,pink
3014,56497,28678,27819,226.0,20314.0,0,pink
3015,31645,15915,15730,177.0,11221.0,0,pink
3016,26939,13913,13026,117.0,8912.0,0,pink
3017,19217,9380,9837,92.0,7441.0,0,pink
3018,60486,31758,28728,303.0,23293.0,0,pink
3019,27278,13629,13649,172.0,10251.0,0,pink
3020,24741,12717,12024,139.0,10003.0,0,pink
3021,105252,50751,54501,239.0,31312.0,0,pink
3022,13467,6784,6683,54.0,5887.0,0,pink
3023,17624,8861,8763,81.0,5244.0,0,pink
3024,25324,12904,12420,118.0,9352.0,0,pink
3025,42547,22082,20465,213.0,13882.0,0,pink
3026,7056,3434,3622,24.0,2403.0,0,pink
3027,7507,3443,4064,50.0,2529.0,0,pink
3028,8531,4154,4377,40.0,2594.0,0,pink
3029,33837,16429,17408,152.0,11431.0,0,pink
3030,56652,28790,27862,247.0,20837.0,0,pink
3031,76232,38044,38188,436.0,30508.0,0,pink
3032,29065,14204,14861,107.0,12097.0,0,pink
3033,9932,4967,4965,38.0,3053.0,0,pink
3034,14205,7171,7034,54.0,4618.0,0,pink
3035,13018,7024,5994,75.0,3867.0,0,pink
3036,16951,8371,8580,87.0,5956.0,0,pink
3037,7027,3487,3540,40.0,2470.0,0,pink
3038,8909,4472,4437,37.0,2747.0,0,pink
3039,24605,12405,12200,112.0,9066.0,0,pink
3040,40708,20873,19835,152.0,11729.0,0,pink
3041,8518,4319,4199,38.0,2867.0,0,pink
3042,15614,8028,7586,101.0,5505.0,0,pink
3043,5797,2875,2922,28.0,1754.0,0,pink
3044,85556,44310,41246,396.0,27995.0,0,pink
3045,21711,11016,10695,143.0,9671.0,0,pink
3046,20073,9290,10783,73.0,5847.0,0,pink
3047,15712,7782,7930,45.0,4154.0,0,pink
3048,45252,22636,22616,160.0,16081.0,0,pink
3049,14992,7360,7632,49.0,4420.0,0,pink
3050,259786,130962,128824,629.0,102670.0,0,pink
3051,13167,6509,6658,14.0,4194.0,0,pink
3052,15258,7426,7832,49.0,5123.0,0,pink
3053,49807,24853,24954,139.0,16885.0,0,pink
3054,63635,30557,33078,219.0,22153.0,0,pink
3055,34491,17013,17478,138.0,9046.0,0,pink
3056,56954,27907,29047,149.0,19575.0,0,pink
3057,16288,7798,8490,34.0,5354.0,0,pink
3058,529843,266521,263322,652.0,178538.0,1,purple
3059,87776,41999,45777,385.0,32855.0,0,pink
3060,27439,13904,13535,91.0,8767.0,0,pink
3061,43402,21645,21757,98.0,14446.0,0,pink
3062,44498,22126,22372,84.0,15562.0,0,pink
3063,102991,52117,50874,222.0,36545.0,0,pink
3064,4337,2062,2275,18.0,1378.0,0,pink
3065,102315,52013,50302,324.0,39139.0,0,pink
3066,9018,4477,4541,57.0,3349.0,0,pink
3067,51828,24908,26920,163.0,15430.0,0,pink
3068,36864,18634,18230,66.0,11596.0,0,pink
3069,18757,9320,9437,73.0,6355.0,0,pink
3070,23620,11728,11892,36.0,6878.0,0,pink
3071,5715,2800,2915,51.0,1822.0,0,pink
3072,20506,9551,10955,49.0,6959.0,0,pink
3073,84652,42309,42343,273.0,26832.0,0,pink
3074,26419,12352,14067,78.0,9404.0,0,pink
3075,168330,85018,83312,733.0,56381.0,0,pink
3076,20360,10081,10279,71.0,6844.0,0,pink
3077,117850,60489,57361,221.0,43619.0,0,pink
3078,16735,8292,8443,34.0,4425.0,0,pink
3079,19164,9443,9721,108.0,6740.0,0,pink
3080,27848,13849,13999,167.0,8980.0,0,pink
3081,79407,39956,39451,221.0,25096.0,0,pink
3082,135264,67288,67976,548.0,49237.0,0,pink
3083,40537,20162,20375,150.0,14479.0,0,pink
3084,15207,7461,7746,78.0,4644.0,0,pink
3085,4579,2255,2324,16.0,2392.0,0,pink
3086,954209,492539,461670,2582.0,340082.0,1,purple
3087,45502,22483,23019,111.0,14721.0,0,pink
3088,37556,18369,19187,134.0,13346.0,0,pink
3089,35345,17621,17724,154.0,10904.0,0,pink
3090,184754,92513,92241,450.0,64526.0,0,pink
3091,88284,44942,43342,212.0,27765.0,0,pink
3092,7262,3566,3696,21.0,2319.0,0,pink
3093,41603,20962,20641,81.0,13565.0,0,pink
3094,43349,21507,21842,137.0,15144.0,0,pink
3095,70599,35091,35508,181.0,22769.0,0,pink
3096,13490,6677,6813,42.0,4053.0,0,pink
3097,195398,98696,96702,759.0,71095.0,0,pink
3098,17539,8705,8834,57.0,4978.0,0,pink
3099,161769,82115,79654,473.0,55150.0,0,pink
3100,14183,7074,7109,63.0,4198.0,0,pink
3101,63596,31849,31747,167.0,20969.0,0,pink
3102,16370,8031,8339,75.0,6568.0,0,pink
3103,41009,20488,20521,167.0,14506.0,0,pink
3104,115205,57283,57922,372.0,40144.0,0,pink
3105,87917,44018,43899,178.0,31139.0,0,pink
3106,20356,9971,10385,83.0,5775.0,0,pink
3107,29438,14506,14932,75.0,9928.0,0,pink
3108,30516,15214,15302,119.0,7649.0,0,pink
3109,21593,10662,10931,110.0,6504.0,0,pink
3110,103013,51639,51374,313.0,33258.0,0,pink
3111,15689,7918,7771,53.0,5034.0,0,pink
3112,134535,67781,66754,372.0,46670.0,0,pink
3113,398879,202776,196103,1243.0,139307.0,0,pink
3114,51444,25147,26297,268.0,16304.0,0,pink
3115,24116,11475,12641,97.0,7656.0,0,pink
3116,169926,84329,85597,418.0,63682.0,0,pink
3117,73274,37218,36056,271.0,26911.0,0,pink
3118,38102,18186,19916,54.0,11536.0,0,pink
3119,11901,5868,6033,67.0,3094.0,0,pink
3120,47708,23149,24559,161.0,13898.0,0,pink
3121,15477,7145,8332,55.0,5211.0,0,pink
3122,13997,6791,7206,59.0,3697.0,0,pink
3123,7410,3680,3730,32.0,1575.0,0,pink
3124,40076,19941,20135,204.0,16807.0,0,pink
3125,13438,6490,6948,65.0,4647.0,0,pink
3126,4680,2293,2387,20.0,1448.0,0,pink
3127,8515,4038,4477,21.0,2376.0,0,pink
3128,97692,48232,49460,320.0,31543.0,0,pink
3129,19011,9316,9695,38.0,4911.0,0,pink
3130,80610,39794,40816,310.0,25851.0,0,pink
3131,2448,1360,1088,12.0,884.0,0,pink
3132,29121,14845,14276,154.0,7757.0,0,pink
3133,8673,4174,4499,44.0,2298.0,0,pink
3134,30012,15160,14852,91.0,9957.0,0,pink
3135,9951,4584,5367,28.0,2343.0,0,pink
3136,44117,21235,22882,139.0,12497.0,0,pink
3137,23059,11148,11911,17.0,12157.0,0,pink
3138,20609,10104,10505,43.0,6444.0,0,pink
3139,8129,3992,4137,50.0,2818.0,0,pink
3140,7100,3332,3768,25.0,1927.0,0,pink
